query	label
has angelika kratzer video messaged me ?	[in:get_message [sl:contact angelika kratzer ] [sl:type_content video video ]
i would like a news update .	[sl:music_type news news ] ]
make an alarm go off tomorrow morning	[in:create_alarm [sl:period tomorrow morning ] ]
show me video messages from atlas	[in:get_message [sl:job video video ] [sl:recipient atlas atlas ] ]
find music by adele	[in:get_info_contact [sl:contact adele adele ] ]
find me tennis matches in seattle this month	[in:get_event [sl:category_event tennis matches ] [sl:location seattle seattle ] [sl:method_timer this month ] ]
can i get a maritime forecast	[in:get_weather [sl:location maritime maritime ] ]
create a new timer alert	[in:create_timer [sl:date_time ]
are there any sports games in may	[in:get_event [sl:category_event sports games ] [sl:method_timer in may ] ]
don't answer calls from frank .	[in:update_reminder_location [sl:contact frank frank ] ]
pause this playlist	[in:pause_timer [sl:music_type playlist playlist ] ]
show me anyone friends with ggb	[in:get_contact [sl:type_relation friends friends ] [sl:education_degree ggb ggb ] ]
whatsapp call matias gould	[in:create_call [sl:music_provider_name whatsapp whatsapp ] [sl:contact matias gould ] ]
set up a reminder to pick up lilly from ballet in 3 hours .	[in:create_reminder [sl:todo pick ballet ] [sl:period in hours ] ]
does tina work at kaiser permanente ?	[in:get_employer [sl:contact tina tina ] [sl:location kaiser permanente ] ]
make a timer for 18 minutes and one for 20 minutes	[in:create_timer [sl:method_timer timer timer ] [sl:date_time for minutes ] [sl:amount one one ] [sl:method_timer one one ] [sl:date_time for minutes ] ]
add john to the following call	[in:update_call [sl:recipes_attribute john john ] ]
set two reminders , one for one hour and another for three hours before the meeting .	[in:create_reminder [sl:amount two two ] [sl:amount two one ] [sl:date_time for hour ] [sl:todo [in:get_todo [sl:date_time for meeting ] [sl:todo the meeting ] ] ] ]
when did sam get his diploma ?	[in:get_major [sl:contact sam sam ] ]
i would like an alarm for 5 this evening	[in:create_alarm [sl:period for evening ] ]
remind me of the soccer game that is today at 3 pm .	[in:create_reminder [sl:person_reminded me me ] [sl:todo the game ] [sl:date_time today pm ] ]
do i need to defrost chicken before putting it in the crock pot	[in:is_true_recipes [sl:recipes_cooking_method defrost defrost ] [sl:music_type chicken chicken ] [sl:recipes_cooking_method crock pot ] ]
call camille number two	[in:create_call [sl:contact camille camille ] [sl:recipes_attribute two two ] ]
will it be humid tomorrow	[in:get_weather [sl:weather_attribute humid humid ] [sl:period tomorrow tomorrow ] ]
create reminder about milk	[sl:amount [sl:todo milk milk ] ]
is susan single ?	[in:get_info_contact [sl:contact susan susan ] [sl:music_type single single ] ]
what is the temperature going to be tonight ?	[in:get_weather [sl:period tonight tonight ] ]
add 30 more seconds to my timer .	[in:add_time_timer [sl:method_timer timer timer ] [sl:date_time 30 seconds ] ]
how many cups of flour to make a small pizza	[in:get_info_recipes [sl:recipes_attribute how many ] [sl:recipes_unit_measurement cups cups ] [sl:recipes_dish pizza pizza ] ]
bring up all my pet grooming reminders for september and october .	[in:create_reminder [sl:amount all all ] [sl:person_reminded my my ] [sl:todo pet grooming ] [sl:date_time for october ] ]
call ebony	[in:create_call [sl:contact ebony ebony ] ] [in:set_default_provider_music
can you call hudson garza using whatsapp	[in:create_call [sl:contact hudson garza ] [sl:music_provider_name whatsapp whatsapp ] ]
what is he weather outside like right now	[in:get_weather ] ]
create a reminder for uncle bill to call traci this wednesday about the cottage .	[in:create_reminder [sl:person_reminded [in:get_contact [sl:type_relation uncle uncle ] [sl:contact traci traci ] ] ] [sl:date_time this wednesday ] [sl:todo the cottage ] ] ]
how much time left on current timer for jogging ?	[in:get_timer [sl:date_time on current ] [sl:method_timer timer timer ] ]
is it below 26 in degree c menlo park tomorrow morning	[in:get_weather [sl:weather_attribute below below ] [sl:weather_attribute 26 26 ] [sl:weather_temperature_unit c park ] [sl:location menlo park ] [sl:date_time tomorrow morning ] ]
play a different playlist	[in:play_music [in:create_timer [sl:music_genre different different ] [sl:music_type playlist playlist ] ]
things going on in des moines	[sl:recipes_unit_measurement [sl:location des moines ] ]
would you can you send video message to stevie on whatsapp	[in:send_message [sl:recipient stevie stevie ] [sl:name_app whatsapp whatsapp ] ]
set alarm october 10th	[in:create_alarm [sl:period october 10th ] ]
what is the nutrition info for chicken	[in:get_recipes [sl:recipes_dish chicken chicken ] ]
when did jane video call me ?	[in:ignore_call [sl:contact jane jane ] ]
respond with a video message	[in:send_message [sl:recipes_meal video video ] ]
please give me details about donald trump newest member in the white house .	[in:get_stories_news [sl:news_type details details ] ]
i wanna snooze the alarm to give me 15 more minutes sleep	[in:snooze_alarm [sl:method_timer alarm alarm ] ]
who am i listening to right now	[in:loop_music ]
why did trump do that	[in:question_news [sl:recipes_included_ingredient trump trump ] ]
send comic con to mary	[in:send_message [sl:content_exact comic con ] [sl:recipient mary mary ] ]
do i have any reminders for saturday	[in:get_reminder [sl:person_reminded i i ] [sl:period for saturday ] ]
change it to video call please	[in:update_method_call ] ]
please delete the reminder to fix my dryer	[in:delete_reminder [sl:recipes_attribute fix dryer ] ]
what is the weather at 11 pm ?	[in:get_weather [sl:period at pm ] ]
what are the top headlines in entertainment	[in:get_stories_news [sl:news_reference top top ] [in:get_alarm [sl:news_type headlines headlines ] [sl:news_category entertainment entertainment ] ]
time this sprint	[in:create_timer [sl:method_timer time time ] [sl:news_source sprint sprint ] ]
respond to laura mcintosh evans with a video message	[in:send_message [sl:recipient laura evans ] [sl:recipes_meal video video ] ]
rain chances for orlando tomorrow evening please ?	[sl:weather_attribute rain rain ] [sl:date_time tomorrow evening ] ]
where is donald trump traveling today	[in:get_location [sl:contact donald trump ] [sl:date_time today today ] ]
find me an easy recipe for chicken parm	[in:get_recipes [sl:recipes_attribute easy easy ] [sl:recipes_included_ingredient chicken parm ] ]
what are the current wind speeds	[sl:weather_attribute wind wind ] ]
what are the headlines saying about donald trump right now	[in:get_stories_news [sl:news_type headlines headlines ] [sl:recipes_included_ingredient donald trump ] ]
make a new alarm for tommorow night at 8 pm .	[in:create_alarm [sl:period for pm ] ]
how do you make pork carnitas	[in:get_recipes [sl:recipes_included_ingredient pork carnitas ] [sl:recipes_dish pork carnitas ] ]
call my wife brianna anderson through whatsapp	[in:create_call [sl:contact [in:get_contact [sl:contact_related my my ] [sl:type_relation wife wife ] [sl:contact brianna anderson ] ] ] [sl:name_app whatsapp whatsapp ] ] [in:get_employer
can you get more events similar to this please ?	[in:get_event [in:update_reminder_location [sl:similarity similar similar ] ]
display availability	[sl:music_album_title ]
remind me to get extra food and treats for the dogs	[sl:recipes_attribute get dogs ]
i'd like to call fernando damien sanders	[in:create_call [in:create_call [sl:contact fernando sanders ] ] ]
remind me to take my birth control .	[sl:recipes_attribute [in:create_reminder [sl:person_reminded me me ] [sl:todo take control ] ]
tell matt w i miss him	[in:send_message [sl:recipient matt w ] [sl:recipient i w ] ]
send a message to shady oaks thread that says are you free	[in:send_message [sl:recipient shady oaks ] [sl:content_exact are free ] ]
please remind me for the next business meeting	[in:create_reminder [sl:person_reminded me me ] [sl:todo the meeting ] ] [sl:recipes_unit_nutrition
is there cumin in this dish	[in:is_true_recipes [sl:recipes_dish cumin dish ] ]
set alarms at 6 am 6 : 15 am 6 : 30 am	[in:create_alarm [sl:period at am ] [sl:date_time 6 am ] ]
how do i make pie crust	[sl:recipes_attribute [in:get_recipes [sl:recipes_dish pie crust ] ]
please call melissa maldonado 's niece	[in:create_call [sl:contact [in:get_contact [sl:category_event melissa maldonado ] [sl:type_relation niece niece ] ] ] ]
send a message to my sister suzanne and tell her the jones are coming on friday	[in:send_message [sl:recipient [in:get_contact [sl:contact_related my my ] [sl:type_relation sister sister ] [sl:recipient suzanne suzanne ] ] [sl:content_exact the friday ] ]
remind me to leave for hair appointment at 10 am tomorrow .	[in:create_reminder [sl:person_reminded me me ] [sl:todo leave appointment ] [sl:period at tomorrow ] ]
what is the weather going to be in san francisco at 3 pm	[in:get_weather [sl:location san francisco ] [sl:period at pm ] ]
is it going to drop below freezing tonight ?	[in:get_weather [sl:weather_attribute freezing freezing ] [sl:date_time tonight tonight ] ]
repeat whole album	[sl:music_type album album ] ]
remind me to text mom the address to the party tonight .	[in:create_reminder [sl:person_reminded me me ] [sl:todo [in:send_message [sl:method_message text text ] [sl:recipient [in:get_contact [sl:type_relation mom mom ] ] ] ] [sl:method_message the tonight ] ] ] [sl:date_time tonight tonight ] ]
add five minutes to the timer	[in:add_time_timer [sl:date_time five minutes ] [sl:date_time timer timer ] ]
would you make an alarm for 10 minutes from now	[in:create_alarm [sl:period for now ] ]
delete my most recent reminder .	[in:delete_reminder [sl:person_reminded my my ] [sl:ordinal recent recent ] ]
show me the list of reminders i have	[in:get_reminder_date_time [sl:person_reminded i i ] ]
what is the weather in boise idaho like in october ?	[in:get_weather [sl:location boise idaho ] [sl:period in october ] ]
parties tonight	[in:get_event [sl:category_event parties parties ] [sl:period tonight tonight ] ]
give me the news .	[sl:music_type news news ] ]
please create a 45 minute timer and name it guests please leave	[in:create_timer [sl:date_time 45 minute ] [sl:weather_attribute timer timer ] ]
i'd like to leave a video message now	[in:send_message [sl:recipes_meal video video ] ]
what will the weather be like between april 30th and may 5th ?	[in:get_weather [sl:period between 5th ] ]
can you please play nine inch nails on spotify ?	[in:play_music [sl:music_track_title nine nails ] [sl:music_provider_name spotify spotify ] ]
pull up music library	[in:get_recipes [sl:recipes_dish music library ] ]
delete the homework reminder	[in:delete_reminder [sl:recipes_attribute [sl:todo homework homework ] ]
have i set a reminder for september 5th at 6 : 30 pm ?	[in:create_reminder [sl:person_reminded i i ] [sl:date_time for pm ] ]
on monday what will the weather be like ?	[in:get_weather [sl:period on monday ] ]
set timer alarm for 15 minutes after start	[in:create_alarm [sl:method_timer timer timer ] [sl:date_time for minutes ] ]
is there something fun happening today	[in:get_event [sl:period today today ] ]
add 3 and a half minutes to timer	[in:add_time_timer [sl:date_time 3 minutes ] [sl:date_time timer timer ] ]
text mom and tell her ill be at the show next thursday	[in:send_message [sl:recipient [in:get_contact [sl:type_relation mom mom ] ] ] [sl:attendee her her ] [sl:date_time next thursday ] ]
set a reccuring a larm to go off at 4 am on sundays for 3 weeks	[in:create_alarm [sl:date_time at sundays ] [sl:date_time for weeks ] ]
read me the cover page of new york times	[in:get_stories_news [sl:news_source new times ] ]
what 's the latest national news ?	[in:get_stories_news [sl:period latest latest ] [sl:news_category national national ] [sl:news_type news news ] ]
add driver license renewal to my errands reminder tomorrow	[in:update_reminder_todo [sl:todo driver renewal ] [sl:person_reminded my my ] [sl:method_timer errands errands ] [sl:date_time tomorrow tomorrow ] ]
call the grandmother of sienna wilkinson	[in:create_call [sl:contact [in:get_contact [sl:type_relation grandmother grandmother ] [sl:contact_related sienna wilkinson ] ] ] ] ]
give me germany weekly news	[in:get_stories_news [sl:news_source germany germany ] [sl:news_type news news ] ]
any news update of the korean attacks ?	[in:get_stories_news [sl:news_type news news ] [sl:news_reference korean korean ] ]
should i wear rainboots to school today ?	[in:get_weather [sl:weather_attribute rainboots rainboots ] [sl:location school school ] [sl:date_time today today ] ]
how old will graham be in 2020 ?	[in:get_age [sl:contact graham graham ] [sl:method_timer in 2020 ] ]
stop calling ira gonzales	[in:silence_alarm [sl:contact ira gonzales ] ]
set a reminder to send my rent money at 8 am tomorrow morning .	[in:create_reminder [sl:todo send money ] [sl:period at morning ] ]
call maeve ' s wife	[in:create_call [sl:contact [in:get_contact [sl:category_event wife wife ] [sl:type_relation wife wife ] ] ] ]
play some foo fighters .	[in:play_music [sl:music_artist_name foo fighters ] ]
message mabel and ask her to milk the cows before i come home	[in:send_message [sl:recipient mabel mabel ] [sl:method_message milk before ] [sl:location [in:question_news ] ]
anything to do next weekend	[in:get_event [sl:period next weekend ] ]
events saturday	[in:get_event [sl:period saturday saturday ] ]
what reminders do we this weekend ?	[in:get_reminder [sl:person_reminded we we ] [sl:method_timer this weekend ] ]
is susan online now	[in:get_availability [sl:contact susan susan [in:reply_message ]
set alarm for 5 am .	[in:create_alarm [sl:period for am ] ]
what kind of event is hocus pocus ?	[in:question_news [sl:news_topic hocus pocus ] ]
things to do next thursday in georgia	[in:get_event [sl:period next thursday ] [sl:location georgia georgia ] ]
remind me to buy cat food tomorrow	[in:create_reminder [sl:person_reminded me me ] [sl:todo buy food ] [sl:period tomorrow tomorrow ] ]
set a reminder to take cake out in 30 minutes	[in:create_reminder [sl:todo take out ] [sl:period in minutes ] ]
please call tobias richard adams	[in:get_call [sl:contact tobias adams ] ]
please , set an alarm for 7 a.m .	[in:create_alarm [sl:period for a.m ] ]
subtract 15 minutes	[in:delete_alarm [sl:date_time 15 minutes ] ]
whats going on in grafton this weekend	[in:get_event [sl:location grafton grafton ] [sl:method_timer this weekend ] ]
how do you cook a whole turkey	[in:get_info_recipes [sl:recipes_included_ingredient turkey turkey ] ]
set status to busy	[in:set_unavailable ] [in:silence_alarm
can i listen to sexy back by justin timberlake ?	[in:play_music [sl:music_track_title sexy back ] [sl:contact justin timberlake ] ]
can you teach me how to make an apple pie	[in:get_recipes [sl:recipes_dish apple pie ] ]
cancel the timer for that time	[in:delete_timer [sl:amount ]
how to cook the best veggie burger	[in:get_recipes [sl:recipes_dish veggie burger ] ]
remind me to schedule an appointment with dr . jones for anytime next week	[in:create_reminder [sl:person_reminded me me ] [sl:todo [in:get_todo [sl:todo schedule appointment ] [sl:attendee dr jones ] ] ] [sl:period for week ] ]
where does jessica live ?	[in:get_location [sl:contact jessica jessica ] ] [in:get_employer
remind me at 8 pm on friday for landry to take round 2 of her medication .	[in:create_reminder [sl:person_reminded me me ] [sl:date_time at friday ] [sl:todo [in:get_todo [sl:todo take landry ] [sl:date_time 2 her ] [sl:todo her medication ] ] ] ]
send a message to the fishing guide that i want to book a trip .	[in:send_message [sl:group fishing guide ] [sl:content_exact i trip ] ]
where is li 's workplace located ?	[in:get_airquality [sl:contact li li ] ]
how many of my friends birthdays are in december ?	[in:get_contact [sl:contact_related my my ] [sl:type_relation friends friends ] [in:set_unavailable ] [sl:date_time in december ] ]
tell me who is online that i know .	[in:get_message_contact [sl:recipient me i ] ]
please message jemima that i will join her for the weekend lunch .	[in:send_message [sl:recipient jemima jemima ] [sl:recipient i her ] [sl:content_exact i lunch ] ]
read me some of the headlines from cnn .	[in:get_stories_news [in:help_reminder [sl:news_type headlines headlines ] [sl:news_source cnn cnn ] ]
set alarm for 2 : 30 pm tomorrow	[in:create_alarm [sl:period for tomorrow ] ]
what action movies are opening this week	[in:get_event [sl:category_event action movies ] [sl:period this week ] ]
are there any headlines on the nfl scandal ?	[in:get_stories_news [sl:news_type headlines headlines ] [sl:recipes_included_ingredient nfl scandal ] ]
message my mother that i will be able to attend the 4th of july event with her .	[in:send_message [sl:recipient [in:get_contact [sl:contact_related my my ] [sl:mutual_school mother mother ] ] ] [sl:content_exact i her ] ]
please read the details on the protests happening in virginia right now	[in:get_stories_news [in:help_reminder [sl:news_type details details ] [sl:news_topic protests virginia ] ]
start call with jenny	[in:create_call [sl:contact jenny jenny ] ] [in:silence_alarm
remind andy to send flowers to his mother	[in:send_message [sl:person_reminded andy andy ] [sl:todo send mother ] ]
rsvp maybe to this event	[sl:recipes_unit_nutrition ]
show my reminders for the st . joseph novena group	[in:get_reminder [sl:method_retrieval_reminder show show ] [sl:person_reminded my my ] [sl:todo the group ] ]
find me a recipe using eggplant and sausage	[in:get_recipes [sl:recipes_dish eggplant eggplant ] [sl:recipes_included_ingredient sausage sausage ] ]
who is currently working at the directv in boise ?	[in:get_contact [sl:employer directv directv ] [sl:location boise boise ] ]
remind me to wake up at 5 today	[in:create_reminder [sl:person_reminded me me ] [sl:todo wake up ] [sl:period at today ] ]
set up reminders for all of my appointments next week one day ahead of time for each	[in:create_reminder [sl:amount all all ] [sl:person_reminded my my ] [sl:todo [in:get_todo [sl:todo appointments appointments ] [sl:date_time next week ] ] ] [sl:date_time one each ] ]
give me news headlines involving donald trump .	[in:get_stories_news [sl:news_type news headlines ] [sl:recipes_included_ingredient donald trump ] ]
i might want to go to the second event	[in:set_rsvp_no [sl:ordinal second second ] ]
set me two alarms for saturday to wake me up at 6 am and 7 am	[in:create_alarm [sl:amount two two ] [sl:date_time for saturday ] [sl:alarm_name wake up ] [sl:date_time at am ] ]
cancel all reminders with sasha	[in:delete_reminder [sl:amount all all ] [sl:todo [in:get_todo [in:get_todo [sl:attendee sasha sasha ] [sl:todo sasha sasha ] ] ] ]
how long has sam worked for abc tech ?	[in:get_employment_time [sl:contact sam sam ] [sl:school abc tech ] ]
snooze alarm 8 minutes	[in:snooze_alarm [sl:period 8 minutes ] ]
what was lily 's major in college ?	[in:get_undergrad [sl:contact lily lily ] ]
remind me to go to eye doctor tomorrow at 1 pm	[in:create_reminder [sl:person_reminded me me ] [sl:todo go doctor ] [sl:period tomorrow pm ] ]
i want to listen to classic rock .	[sl:music_type classic rock ] ]
who is ross ?	[in:get_contact [sl:contact ross ross ] ]
can i hear the acoustic version of this song ?	[in:play_music [sl:music_type acoustic version ] [sl:music_type song song ] ]
who works in san jose ?	[in:get_contact [sl:employer san jose ] ]
video message jonas	[in:send_message [sl:recipes_meal video video ] [sl:recipient jonas jonas ] ]
set alarm for one hour before party	[in:create_alarm [sl:date_time for before ] [sl:news_topic party party ] ]
what is the best recipe for chicken salad	[in:get_recipes [sl:recipes_rating best best ] [sl:recipes_included_ingredient chicken salad ] ]
how 's the weather going to treat us on sunday ?	[in:get_weather [sl:location us us ] [sl:period on sunday ] ]
cancel reminder to call dentist	[in:delete_alarm [sl:todo [in:create_call [sl:contact dentist dentist ] ] ] ]
top stories on cnn	[in:get_stories_news [sl:news_reference top top ] [sl:news_type stories stories ] [sl:life_event cnn cnn ] ]
reminder to make dentist app for myself for next week	[in:create_reminder [sl:todo make app ] [sl:period for week ] ]
who is ming park 's husband ?	[in:get_contact [sl:category_event ming park ] [sl:type_relation husband husband ] ]
how long on your nap is over timer	[in:create_timer [sl:timer_name nap over ] [sl:method_timer timer timer ] ]
transfer to another call	[in:ignore_call ]
message elizabeth that i will take her to the halie 's birthday party on sunday	[in:send_message [sl:recipient elizabeth elizabeth ] [sl:recipes_type i sunday ] ]
dial melissa maldonado on whatsapp	[in:create_call [sl:contact melissa maldonado ] [sl:name_app whatsapp whatsapp ] ] [in:get_employer
text on my way to tony and paul	[in:send_message [sl:attendee tony tony ] [sl:recipient paul paul ] ]
what happened with the bp oil spill	[in:get_recipes [sl:recipes_dish bp spill ] ]
how long do i cook chicken breast	[in:get_info_recipes [sl:recipes_attribute how long ] [sl:timer_name chicken breast ] ]
add an alarm	[in:end_call ]
play some classic rock music	[in:play_music [sl:music_genre classic rock ] [sl:recipes_included_ingredient music music ] ]
suspend the timer	[in:pause_timer [sl:date_time the timer ] ]
remind george to buy a birthday present for uncle sam in time for his party .	[in:send_message [sl:person_reminded george george ] [sl:todo buy party ] ]
delete reminder about jason 's immunizations	[in:delete_reminder [sl:alarm_name jason immunizations ] ]
what 's happening in kansas city tonight	[in:get_event [sl:location kansas city ] [sl:method_timer tonight tonight ] ]
tell me what the weather looks like for easter ?	[in:get_weather [sl:period for easter ] ]
what is the proper temperature to cook chicken to	[in:get_info_recipes [sl:amount temperature temperature ] [sl:recipes_included_ingredient chicken chicken ] ]
i don't want to get those reminders about back to school event anymore	[in:delete_reminder [sl:todo back school ] ]
who called earlier	[in:get_reminder_amount ]
can you record a video message for dessie menapace	[in:send_message [sl:recipes_meal video video ] [sl:recipient dessie menapace ] ]
call connor e	[in:create_call [in:create_call [sl:contact connor e ] ] ]
set an alarm for 1525h	[in:create_alarm [sl:period for 1525h ] ]
i want to call 5558156 on my cell phone	[in:create_call [in:get_gender [sl:phone_number 5558156 5558156 ] ]
make alarm snooze for an hour	[in:snooze_alarm [sl:period [sl:date_time for hour ] ]
update reminder meet monica for lunch at 12 pm to 1 pm .	[in:update_reminder_date_time [sl:todo meet lunch ] [sl:date_time at pm ] [sl:period to pm ] ]
ignore all the calls from contenta	[in:ignore_call [sl:ordinal all all ] ]
set an alarm for 11 am on the 26th	[in:create_alarm [sl:period for 26th ] [sl:date_time the 26th ] ]
change the reminder that says get gas	[sl:method_retrieval_reminder [in:create_reminder [sl:todo get gas ] ]
i'm not available	[in:set_rsvp_no ]
how to make healthier brownies	[in:get_recipes [sl:recipes_included_ingredient healthier healthier ] [sl:recipes_dish brownies brownies ] ]
stop playlist	[in:stop_music [sl:music_type playlist playlist ] ]
delete playlist	[in:remove_from_playlist_music [sl:music_type playlist playlist ] ]
what is my 10 - day weather outlook	[in:get_weather [sl:period 10 day ] ]
unavailable at this time	[in:pause_timer ]
turn loop off	[in:silence_alarm ]
concerts in omaha	[sl:contact_related concerts concerts ] [sl:location omaha omaha ] ]
how do i cut an avocado	[in:get_recipes [sl:recipes_cooking_method cut avocado ] ]
reply to the coworker thread with text	[in:send_message [sl:recipient coworker coworker ] ]
message to grandma to be at our house by 5 : 00 pm	[in:send_message [sl:recipient [in:get_contact [sl:type_relation grandma grandma ] ] ] [sl:content_exact to pm ] ]
tell me names of people work at kfc , ain shams branch .	[in:get_contact [sl:school kfc branch ] ]
how do you make salsa	[in:get_recipes [sl:recipes_included_ingredient salsa salsa ] ]
how does the weather look like at the beach	[in:get_weather [sl:location beach beach ] ] ]
any friends online	[in:get_availability ] ]
can you set an alarm for 5 .	[in:create_alarm [sl:period for 5 ] ]
please could you delete all of the reminders that i have set up for next week	[in:delete_reminder [sl:amount all all ] [sl:person_reminded i i ] [sl:method_timer for week ] ]
what are the top sports news headlines	[in:get_stories_news [sl:news_reference top top ] [sl:news_category sports sports ] [sl:news_type news headlines ] ]
what is going on this fourth of july in beaverton oregon	[sl:recipes_unit_measurement [sl:method_timer [sl:todo [in:get_todo [sl:date_time this july ] [sl:location beaverton oregon ] ] ] ]
turn on npr	[in:play_music [sl:music_radio_id npr npr ] ]
what is the weather in brooklyn right now	[in:get_weather [sl:alarm_name brooklyn brooklyn ] ]
any live music tonight	[in:get_event [sl:category_event live music ] [sl:method_timer tonight tonight ] ]
give me a 10 minute timer	[in:create_timer [sl:date_time 10 minute ] [in:create_alarm [sl:date_time timer timer ] ]
parties in san francisco during the month of december	[in:get_event [sl:category_event parties parties ] [sl:location san francisco ] [sl:method_timer during december ] ]
start call with david	[in:create_call [sl:contact david david ] ] [in:set_default_provider_music
what temperature is necessary for roasted root vegetables	[in:get_info_recipes [sl:recipes_attribute temperature temperature ] [sl:recipes_cooking_method roasted roasted ] [sl:recipes_dish root vegetables ] ]
give jackson brandon a call	[in:create_call [in:create_call [sl:contact jackson brandon ] ] ]
i'm in the mood for some r & b	[in:get_alarm [sl:alarm_name r b ] ]
does ben live in springfield ?	[in:get_location [sl:contact ben ben ] [sl:news_topic springfield springfield ] ]
what college is rachel currently attending ?	[in:switch_call [sl:contact rachel rachel ] ]
show me all of my reminders .	[in:get_reminder [sl:method_retrieval_reminder show show ] [sl:amount all all ] [sl:person_reminded my my ] ] ]
do i know people from new jersey ?	[in:get_contact [sl:contact_related i i ] [sl:news_topic new jersey ] ]
i need an alarm to remind me to call the dentist	[in:create_alarm [sl:alarm_name [in:create_call [sl:contact the dentist ] ] ]
what 's the forecast for manchester ?	[sl:todo manchester manchester ] ]
what was the update on yesterday news	[in:get_stories_news [sl:method_timer news news ] [sl:date_time on yesterday ] ]
continue timer for cooking	[in:resume_timer [sl:date_time for timer ] ]
what is happening in dallas next weekend	[in:get_event [sl:location dallas dallas ] [sl:period next weekend ] ]
create an alarm for 11.00 am .	[in:create_alarm [sl:period for am ] ]
can you send a video	[in:send_message [sl:type_content video video ] ] ]
did it say it was going to rain today on the news	[in:get_stories_news [sl:news_reference it it ] [sl:news_type news news ] [sl:date_time today today ] ]
cancel reminder to watch insecure sunday	[in:delete_reminder [sl:todo watch insecure ] [sl:method_timer sunday sunday ] ]
wath upon dearne weather please	[in:get_weather [sl:location wath dearne ] ]
make alarms for 3 pm and 11 pm every thursday for the next 8 weeks	[in:create_alarm [sl:period for thursday ] [sl:date_time for weeks ] ]
call earnestine kirkpatric ' s friend	[in:create_call [sl:contact [in:get_contact [sl:category_event earnestine kirkpatric ] [sl:type_relation friend friend ] ] ] ]
accept video call from uncle rudi	[in:answer_call [sl:contact [in:get_contact [sl:type_relation uncle uncle ] [sl:contact rudi rudi [in:cancel_call ] ] ]
hang up on mathias	[in:silence_alarm [sl:contact mathias mathias ] ]
i want names of people who work at taco bell	[in:get_contact [sl:contact_related i i ] [sl:employer taco bell ] ]
cancel my reminder to buy clothes tomorrow .	[in:delete_reminder [sl:person_reminded my my ] [sl:todo buy clothes ] [sl:method_timer tomorrow tomorrow ] ]
call lexi	[in:end_call [sl:contact lexi lexi ] ]
will it be cold enough to wear a jacket in california during christmas ?	[in:get_weather [sl:weather_attribute cold cold ] [sl:weather_attribute jacket jacket ] [sl:location california california ] ]
make timer longer by 15 minutes	[in:create_timer [sl:method_timer timer timer ] [sl:date_time by minutes ] ]
show me all my reminders for today .	[in:get_reminder [sl:method_retrieval_reminder show show ] [sl:amount all all ] [sl:person_reminded my my ] [sl:method_timer for today ] ]
new 15 minute timer	[in:create_timer [sl:date_time 15 minute ] [sl:date_time timer timer ] ]
add abigail	[sl:contact_added abigail abigail ] ]
are there any events going on after midnight on saturday	[in:get_event [sl:period on saturday ] ]
create a video message for victoria with plan options for dinner with family next week	[in:send_message [sl:type_content video video ] [sl:recipient victoria victoria ] [sl:method_message plan week ] ] ]
how many inches of rain are we getting	[sl:weather_attribute rain rain ] ]
reach out to richard	[in:resume_call [sl:contact richard richard ] ]
fix a timer for 2 minutes	[in:create_timer [sl:date_time for minutes ] ]
play the abc song	[in:play_music [sl:music_provider_name abc abc ] [sl:music_type song song ] ]
any fun events in tucson this weekend	[in:get_event [sl:location tucson tucson ] [sl:method_timer this weekend ] ]
have my status reflect available	[in:get_call_time ]
please read me the details about willie nelson 's concert cancellation .	[in:get_stories_news [sl:news_type details details ] [sl:recipes_included_ingredient willie cancellation ] ]
i need a complete list of my friends	[in:get_stories_news [sl:category_event complete list ] [sl:contact_related my my ] [sl:type_relation friends friends ] ]
send jill a message saying the courts at moonlight are full , let 's play at cottonwood park instead	[in:get_message [sl:recipient jill jill ] [sl:content_exact the park ] ]
what song is playing next ?	[sl:music_album_title [sl:ordinal next next ] ]
call lonnie hyacinth cangemi ' s uncle	[in:create_call [sl:contact [in:get_contact [sl:contact_related lonnie hyacinth ] [sl:type_relation uncle uncle ] ] ] ]
who are the doctors who work at the reach animal clinic ?	[in:get_contact [sl:employer animal clinic ] ]
please read me the latest news about selena gomez	[in:get_stories_news [sl:method_timer latest latest ] [sl:news_type news news ] [sl:news_topic selena gomez ] ]
remind me to call ben in 30 minutes	[in:create_reminder [sl:person_reminded me me ] [sl:todo [in:create_call [sl:contact ben ben ] ] [sl:date_time in minutes ] ]
can you send darren the messenger video message	[in:send_message [sl:contact darren darren ] [sl:name_app messenger messenger ] [sl:type_content video video ] ]
show me all my reminder about my baby shower .	[in:get_reminder [sl:method_retrieval_reminder show show ] [sl:amount all all ] [sl:person_reminded my my ] [sl:recipes_included_ingredient my shower ] ]
weather forecast for sat afternoon june 15th	[in:get_weather [sl:period for 15th ] ]
create a playlist : christian mix	[in:create_playlist_music [sl:music_playlist_title christian mix ] ]
snooze for another 40 .	[in:snooze_alarm [sl:period for 40 ] ]
can you give me berts address	[in:get_location [sl:location berts berts ] ]
what are the ingredients of pad thai	[in:get_info_recipes [sl:alarm_name pad thai ] ]
ask my aunt what day the strawberry farm opens .	[in:send_message [sl:todo my opens ] [sl:content_exact what opens ] ]
set timer for 21st dec 2017	[in:create_timer [sl:date_time for 2017 ] [sl:method_timer timer timer ] [sl:date_time for 2017 ] ]
how to bake bread	[in:get_info_recipes [sl:recipes_cooking_method bake bake ] [sl:recipes_dish bread bread ] ]
did anyone i know go to fsu ?	[in:get_contact [sl:contact_related i i ] [sl:employer fsu fsu ] ]
set 3 alarms	[in:create_alarm [sl:ordinal 3 3 ] ]
when did natalie holloway disappear	[in:get_call_time [sl:contact natalie holloway ] ]
find me some healthy chicken recipes	[in:get_recipes [sl:recipes_attribute healthy healthy ] [sl:recipes_included_ingredient chicken chicken ] ]
put araceli hickory sons in law upcoming birthdays on the screen	[in:get_contact [sl:contact_related araceli araceli ] [sl:type_relation sons law ] ]
take a new call	[in:answer_call ]
what are the headlines in the philippines today ?	[in:get_stories_news [sl:news_type headlines headlines ] [sl:location philippines philippines ] [sl:date_time today today ] ]
remind me to walk dog at 7 pm today .	[in:create_reminder [sl:person_reminded me me ] [sl:todo walk dog ] [sl:period at today ] ]
ingredients for chicken pot pie	[in:get_info_recipes [sl:recipes_attribute ingredients ingredients ] [sl:recipes_included_ingredient chicken pie ] ]
set monthly alarm to pay gym membership on 3rd of every month	[in:create_alarm [sl:period monthly monthly ] [sl:alarm_name pay membership ] ]
what is the ideal temperature for medium rare beef	[in:get_info_recipes [sl:recipes_attribute temperature temperature ] [sl:recipes_attribute medium rare ] [sl:recipes_dish beef beef ] ]
is it going to be warm enough to go swimming today ?	[in:get_weather [sl:weather_attribute warm warm ] [sl:period today today ] ]
play popular club music	[in:play_music [sl:music_type music music ] ]
set alarm for 9 am for every day next week .	[in:create_alarm [sl:period for week ] ]
play water under the bridge adele	[in:play_music [sl:music_track_title water adele ] [sl:music_artist_name bridge adele ] ]
music repeat all on	[in:repeat_all_off_music ]
remove my tuesday lunch reminder .	[in:delete_reminder [sl:person_reminded my my ] [sl:date_time tuesday tuesday ] [sl:todo lunch lunch ] ]
get my messages from steve and bill	[in:get_message [sl:contact steve steve ] [sl:recipient bill bill ] ]
will the clouds be moving out today	[in:get_weather [sl:weather_attribute clouds clouds ] [sl:period today today ] ]
set a reminder to call sheila at 9 pm on friday .	[in:create_reminder [sl:todo [in:create_call [sl:contact sheila sheila ] ] ] [sl:method_timer at friday ] ]
what temperature is chicken cooked at	[in:get_info_recipes [sl:recipes_attribute temperature temperature ] [in:create_alarm [sl:recipes_attribute chicken chicken ] ]
who lives in florida ?	[in:get_contact [sl:news_topic florida florida ] ]
i'd like to be set as unavailable right now	[in:set_rsvp_no ]
how many cups of flour are there in bread dough	[in:get_info_recipes [sl:recipes_attribute how many ] [sl:recipes_unit_measurement cups cups ] [sl:weather_attribute flour flour ] [sl:recipes_dish bread dough ] ]
remind me to attend the new zumba classes at 6 : 00 instead of 6 : 30 .	[in:update_reminder_date_time [sl:person_reminded me me ] [sl:todo attend classes ] [sl:date_time at 00 ] [sl:period of 30 ] ]
what will the weather be doing this afternoon in brighton ?	[in:get_weather [sl:period this afternoon ] [sl:location brighton brighton ] ]
who works at pizza hut ?	[in:get_contact [sl:group pizza hut ] ]
show me what the reminders are from today	[in:get_reminder [sl:method_retrieval_reminder show show ] [sl:person_reminded me me ] [sl:period from today ] ]
is jen 48 this year ?	[in:get_age [sl:contact jen jen ] [sl:age 48 48 ] [sl:date_time this year ] ]
send the pictures to lynn .	[in:create_call [sl:contact lynn lynn ] ]
take me to the sporting news .	[in:get_stories_news [sl:category_event sporting sporting ] [sl:news_type news news ] ]
do any of my friends work at starbucks ?	[in:get_contact [sl:contact_related my my ] [sl:type_relation friends friends ] [sl:school starbucks starbucks ] ]
replay the last song please	[sl:music_playlist_title [sl:ordinal last last ] [sl:music_type song song ] ]
can you cancel all reminders ?	[sl:amount all all ]
remind me to update my website on friday .	[in:create_reminder [sl:person_reminded me me ] [sl:todo update website ] [sl:period on friday ] ]
find the happiness begins	[in:get_availability ]
fast forward this song	[in:subtract_time_timer [sl:music_type song song ] ]
list actors born in the 1970s .	[in:get_contact [sl:education_degree actors actors ] [sl:date_time in 1970s ] ]
can you set a reminder for my eye appointment on august 15th at 2 pm ?	[in:create_reminder [sl:todo my appointment ] [sl:period on pm ] ]
is this a cover ?	[in:question_news ]
how is the weather at 4 : 00 pm	[in:get_weather [sl:period at pm ] ]
create alarms everyday at 7 am and 7 : 30 am	[in:create_alarm [sl:period everyday alarms ] [sl:date_time everyday am ] ]
what is the top news story today	[in:get_stories_news [sl:news_reference top top ] [sl:news_type news story ] [sl:period today today ] ]
tell me all the news related to selena gomez .	[in:get_stories_news [sl:news_type news related ] [sl:news_topic selena gomez ] ]
how long should i cook chicken drumsticks at 350 degrees ?	[in:get_info_recipes [sl:recipes_attribute how long ] [sl:recipes_included_ingredient chicken drumsticks ] [sl:date_time at 350 ] ]
what is the safe temp for beef	[in:get_info_recipes [sl:recipes_attribute temp temp ] [sl:news_topic beef beef ] ]
delete alert for road trip extravaganza .	[in:delete_alarm [sl:todo road trip ] ]
get all my reminders for grocery shopping	[in:get_reminder_date_time [sl:amount all all ] [sl:person_reminded my my ] [sl:todo grocery shopping ] ]
what ingredients are in peking ducks	[in:get_info_recipes [sl:recipes_attribute ingredients ingredients ] [sl:location peking ducks ] ]
extend by 5 minutes	[in:update_alarm [sl:date_time by minutes ] ]
is coconut oil easy to cook with	[in:is_true_recipes [sl:recipes_included_ingredient coconut oil ] ]
read me the ingredients in an oreo cookie	[in:get_info_recipes [sl:recipes_attribute ingredients ingredients ] [sl:recipes_diet oreo oreo ] [sl:recipes_dish cookie cookie ] ]
video message allie	[in:send_message [sl:type_content video video ] [sl:contact allie allie ] ]
would you message bill murray and max	[in:send_message [sl:contact bill murray ] [sl:recipient max max ] ]
what temperature are ribs cooked at	[in:get_info_recipes [sl:recipes_attribute temperature temperature ] [sl:recipes_type_nutrition ribs ribs ] ]
help me set a new timer	[in:create_timer [sl:date_time ]
is soy milk vegan	[in:is_true_recipes [sl:recipes_included_ingredient soy milk ] [sl:recipes_diet vegan vegan ] ]
turn on classical music	[sl:music_artist_name classical classical ] [sl:music_type music music ] ]
set alarm every 5 minutes for 25 minutes	[in:create_alarm [in:subtract_time_timer [sl:period every minutes ] [sl:date_time for minutes ] ]
what 's the forecast for this saturday	[in:get_weather [sl:period for saturday ] ]
when is the timer going to go off ?	[in:get_alarm [sl:method_timer timer timer ] ]
rsvp yes to tedxseattle	[in:set_rsvp_yes [sl:title_event tedxseattle tedxseattle ] ] [in:set_rsvp_yes
who called me at noon today ?	[in:get_call [sl:date_time at today ] ]
dial everett hart 's daughter gia	[in:create_call [sl:contact [in:get_contact [sl:category_event everett hart ] [sl:type_relation daughter daughter ] [sl:contact gia gia ] ] ] ]
what is the address of the meeting in tomorrows reminder ?	[in:get_reminder_location [sl:todo the meeting ] [sl:date_time in tomorrows ] ]
start my homeschool tracks	[in:play_music [sl:music_genre homeschool homeschool ] [sl:music_type tracks tracks ] ]
okay , done looping track	[in:loop_music [sl:music_type track track ] ]
delete my 80 ' s playlist	[in:remove_from_playlist_music [sl:music_type playlist playlist ] ]
tell me about nathan .	[in:get_info_contact [sl:contact nathan nathan ]
display the reminders for what i need to bring to the lawyer next week .	[in:get_reminder [sl:method_retrieval_reminder display display ] [sl:person_reminded i i ] [sl:date_time next week ] ]
is it above 42 c at shanghai tomorrow morning	[sl:weather_attribute above above ] [sl:weather_attribute 42 42 ] [sl:weather_temperature_unit c c ] [sl:date_time tomorrow morning ] ]
what 's it going to be like outside at two ?	[in:get_weather [sl:period at two ] ]
delete monday night football reminder .	[in:delete_reminder [sl:period monday night ] [sl:todo football football ] ]
has the running class chat sent me anything	[sl:sender running class ] [sl:recipient me me ] ]
what temperature is a medium rare steak	[in:get_info_recipes [sl:recipes_attribute temperature temperature ] [sl:recipes_attribute medium rare ] [sl:recipes_included_ingredient steak steak ] ]
snooze alarm	[in:snooze_alarm ] [sl:recipes_excluded_ingredient
things to do in philadelphia next weekend	[in:get_event [sl:location philadelphia philadelphia ] [sl:period next weekend ] ]
rewind ten seconds .	[in:pause_music [sl:music_rewind_time ten seconds ] ]
hang up chauncey l filburn	[in:merge_call [sl:contact chauncey filburn ] ]
cancel the reminder about jane 's party .	[in:delete_alarm [sl:todo jane party ] ]
play the album when it 's dark out on iheartradio	[in:play_music [sl:music_type album album ] [sl:news_source when out ] [sl:music_provider_name iheartradio iheartradio ] ]
i want to see headlines about murders	[in:get_stories_news [sl:news_type headlines headlines ] [sl:news_category murders murders ] ]
play the 1979 leaving neverland	[in:play_music [sl:music_artist_name leaving neverland ] ]
add milk and bagels to my grocery reminder this week .	[in:update_reminder_todo [sl:alarm_name milk milk ] [sl:person_reminded my my ] [sl:todo grocery grocery ] [sl:date_time this week ] ]
get me all reminders set for the dogs .	[in:get_reminder [sl:person_reminded me me ] [sl:amount all all ] [sl:todo dogs dogs ] ]
call brooklynn ' s cousin	[in:create_call [sl:contact [in:get_contact [sl:category_event cousin cousin ] [sl:type_relation cousin cousin ] ] ] ]
call bella	[in:create_call [sl:contact bella bella ] ] [in:set_default_provider_music
please tell me the weather in poland	[sl:weather_attribute [in:get_weather [sl:location poland poland ] ]
should i bring a jacket to san juan , pr next monday	[in:get_weather [sl:weather_attribute jacket jacket ] [sl:location san pr ] [sl:period next monday ] ]
ignore the call from joyce .	[in:remove_from_playlist_music [sl:music_rewind_time joyce joyce ]
please switch the call over to jackson brandon	[in:answer_call [sl:contact jackson brandon ] ]
start a call to mum	[in:end_call [sl:contact [in:get_contact [sl:type_relation mum mum ] ] ] ]
add this track to kiddos playlist	[in:add_to_playlist_music [sl:music_type track track ] [sl:music_provider_name kiddos kiddos ] [sl:music_type playlist playlist ] ]
what genre of music is calming ?	[in:set_rsvp_yes [sl:music_type music music ] ]
let me see messages from my mom kayson	[in:get_reminder [sl:person_reminded [in:get_contact [sl:contact_related my my ] [sl:type_relation mom mom ] [sl:contact kayson kayson ] ] ] ]
send a message to rosanne asking if the rain has stopped at our house	[in:send_message [sl:recipient rosanne rosanne ] [sl:method_message the asking ] [sl:content_exact the house ] ] ]
ask matt if he remembers our first date	[in:send_message [sl:recipient matt matt ] [sl:location he date ] ]
turn the timer on for five minutes .	[in:create_timer [sl:method_timer timer timer ] [sl:date_time on minutes ] ]
does paul turns 67 in july ?	[in:get_education_time [sl:contact paul paul ] [sl:age 67 67 ] [sl:date_time in july ] ]
whats the weather going to be for this weekend ?	[in:get_weather [sl:period for weekend ] ]
what is happening in baton rouge , la next week on tuesday	[in:get_event [sl:location baton la ] [sl:period next tuesday ] ]
set alarm for 6 am every monday	[in:create_alarm [sl:period for monday ] ]
on what album would i find this song	[in:get_track_info_music [sl:music_type album album ] [sl:music_type song song ] ]
always answer calls from randy	[in:ignore_call [sl:contact randy randy ] ]
get me video messages from my daughter	[in:get_message [sl:type_content video video ] [sl:recipient [in:get_contact [sl:contact_related my my [in:like_music [sl:type_relation daughter daughter ] ] ] ] ]
is today going to be overcast ?	[in:get_weather [sl:period today today ] [sl:weather_attribute overcast overcast ] ]
is it snowing on mt . fuji , tomorrow at high noon ?	[in:get_weather [sl:weather_attribute snowing snowing ] [sl:location mt , ] [sl:date_time tomorrow noon ] ]
call jessica and brian	[in:answer_call [sl:contact jessica jessica ] [sl:contact brian brian ] ]
hang up now	[in:end_call
call cook	[in:create_call ]
set one timer for 21 minutes and a second for 10 seconds and a third for a day	[in:create_timer [sl:amount one one ] [sl:method_timer timer timer ] [sl:date_time for minutes ] [sl:ordinal second second ] [sl:date_time for seconds ] [sl:ordinal third third ] [sl:method_timer for day ] ]
can you set my work out timer to one hour please ?	[in:create_timer [sl:timer_name work out ] [sl:method_timer timer timer ] [sl:date_time to hour ] ]
need a weekly alarm for 5 am on mondays	[in:create_alarm [sl:contact_method weekly weekly ] [sl:date_time for mondays ] ]
how do you make flour from scratch	[in:get_recipes [sl:recipes_dish flour flour ] [sl:recipes_cooking_method from scratch ] ]
when is the heat index highest today ?	[in:get_weather [sl:weather_attribute heat index ] [sl:date_time today today ] ]
pull up all of my event reminders for october and delete them all	[in:delete_reminder [sl:amount all all ] [sl:person_reminded my my ] [sl:todo event event ] [sl:date_time for october ] ]
please set up a timer called pho	[in:create_timer [sl:date_time pho pho ] [sl:method_timer timer timer ] ]
set up an alarm for every wednesday at 6 pm	[in:create_alarm [sl:period for pm ] ]
what is the latest news article about america 's drinking problem ?	[in:get_stories_news [sl:period latest latest ] [sl:news_type news article ] [sl:news_topic america problem ] ]
who sang current song	[sl:music_album_title [sl:music_type song song ] ]
where does david go to work ?	[in:get_life_event [sl:contact david david ] ]
give me all recent news headlines	[in:get_stories_news [sl:method_timer news headlines ] ]
is there flash flooding now	[in:get_weather [sl:music_genre flash flooding ] ]
create a playlist : country gold	[in:replay_music [sl:music_playlist_title country gold ] ]
create a new reminder for tonight .	[in:create_reminder [sl:method_timer for tonight ] ]
send a message to my client letting her know i am running late	[in:send_message [sl:recipient [in:get_contact [sl:contact_related my my ] [sl:content_exact client late ] ] ]
could i have the address information for terry 's current residence ?	[in:get_location [sl:contact_related terry terry ] ]
what are the ingredients in beef stew	[in:get_info_recipes [sl:recipes_attribute ingredients ingredients ] [sl:recipes_included_ingredient beef stew ] ]
tell me about weather for monday afternoon	[in:get_weather [sl:period for afternoon ] ]
remind me to return my library books on friday	[in:create_reminder [sl:person_reminded me me ] [sl:todo return books ] [sl:period on friday ] ]
will it be around 0 degree celcius inside this weekend	[sl:weather_attribute around ] [sl:weather_attribute 0 0 ] [sl:weather_temperature_unit celcius celcius ] [sl:location inside inside ] [sl:date_time this weekend ] ]
end talk	[in:unloop_music ]
weekend events in upstate ny	[in:get_event [sl:period weekend weekend ] [sl:location upstate ny ] ]
play the hits from last summer	[in:play_music [sl:music_playlist_title last hits ] ]
give me a new alarm for 2105h	[in:create_alarm [sl:period for 2105h ] ]
create alarms for mondays at 7 : 15 and 7 : 30 in the morning .	[in:create_alarm [sl:period for morning ] ]
any interesting weather news	[in:get_stories_news [sl:recipes_unit_nutrition weather interesting ] [sl:news_type news news ] ]
who is brandon	[in:get_contact [sl:contact brandon brandon ] ]
call rob please	[in:create_call [in:create_call [sl:contact rob rob ] ]
how will the weather be in blackpool tomorrow ?	[in:get_weather [sl:location blackpool blackpool ] [sl:period tomorrow tomorrow ] ]
friends of laura	[sl:type_relation friends friends ] [sl:contact_related laura laura ] ]
who made the recent news in my town	[in:get_stories_news [sl:date_time recent recent ] [sl:news_type news news ] [sl:news_topic in town ] ]
add a reminder to transfer money to checking on the first of the month .	[in:create_reminder [sl:todo transfer checking ] [sl:period on month ] ]
delete reminder to call husband at 7 pm .	[in:delete_reminder [sl:todo [in:create_call [sl:contact [in:get_contact [sl:type_relation husband husband ] ] ] ] ] [sl:period at pm ] ]
what parties are happening in new jersey friday	[in:get_event [sl:category_event parties parties ] [sl:location new jersey ] [sl:method_timer friday friday ] ]
has the bay area jobs chat messaged me in the last week	[in:get_message [sl:group bay jobs ] [sl:recipient me me ] [sl:period in week ] ]
tell me about today 's weather	[in:get_weather [sl:date_time today today ] ]
remind the family group chat on messenger that politics are not allowed to be discussed .	[in:create_reminder [sl:person_reminded family family ] ] [sl:recipes_unit_nutrition messenger messenger ] [sl:todo are discussed ] ]
start timer at 1 : 00 pm	[in:create_timer [sl:date_time at pm ] [sl:method_timer timer timer ] ]
i want to touch base with timothy	[in:get_education_degree [sl:contact timothy timothy ] ]
i need to take off the reminder for milk	[in:set_rsvp_interested ]
most recent breaking news	[in:get_stories_news [sl:date_time most recent ] [sl:recipes_excluded_ingredient breaking breaking ] [sl:news_type news news ] ]
message debbie and tell her the date of bambam 's party is still the same night .	[in:send_message [sl:recipient debbie debbie ] [sl:recipes_type the night ] ]
timer pause	[in:pause_timer [sl:date_time [sl:method_timer timer timer ] ]
shut down this alarm	[in:silence_alarm ] ]
set up a timer to last for three hours	[in:create_timer [sl:method_timer timer timer ] [sl:period for hours ] ]
send a message to tom and dave and say that the meeting is postponed until tomorrow afternoon .	[in:send_message [sl:recipient tom tom ] [sl:recipient dave dave ] [sl:method_message the afternoon ] ]
latest oj simpson news	[in:get_stories_news [sl:period latest latest ] [sl:news_topic oj simpson ] [sl:news_type news news ] ]
is it foggy outside this morning ?	[in:get_weather [sl:weather_attribute foggy foggy ] [sl:period this morning ] ]
message amy that the sale at marshall 's is july 10 through 15	[in:send_message [sl:recipient amy amy ] [sl:recipes_type the 15 ] ]
remind to put the meatloaf in the oven by 5 : 00 .	[in:create_reminder [sl:person_reminded put meatloaf ] [sl:todo put oven ] [sl:date_time by 00 ] ]
nfl recent news	[in:get_stories_news [sl:news_topic nfl nfl ] [sl:period recent recent ] [sl:news_type news news ] ]
add 5 minutes	[in:update_alarm [sl:date_time 5 minutes ] ]
send a video message via messenger	[in:send_message [sl:type_content video video ] [sl:name_app messenger messenger ] ] [in:get_track_info_music
could you look up a moist cake recipe	[in:get_recipes [sl:recipes_attribute moist moist ] [sl:recipes_type cake cake ] ]
set daily alarm to wakeup at 8 am	[in:create_alarm [sl:period daily daily ] [sl:alarm_name wakeup wakeup ] [sl:date_time at am ] ]
when did li start working for apple ?	[sl:music_radio_id apple li ] [sl:employer apple apple ] ]
what are current news top headlines	[in:get_stories_news [sl:period current current ] [sl:news_type news headlines ] ]
video call ava ira	[in:create_call [sl:contact ava ira ] ] [in:stop_music
alarm for 5 minutes .	[in:create_alarm [sl:period for minutes ] ]
modify alarm name to bake cake	[in:update_alarm [sl:alarm_name bake cake ] ]
please message missy and tell her i had a wonderful time at the beach .	[in:send_message [sl:recipient missy missy ] [sl:attendee her beach ] [sl:content_exact i beach ] ]
recent news about the arts	[in:get_stories_news [sl:date_time recent recent ] [sl:news_type news news ] [sl:news_topic arts arts ] ]
remind me to get milk	[sl:recipes_attribute [in:create_reminder [sl:person_reminded me me ] [sl:todo get milk ] ]
remind me that i need to stop for gas	[in:create_reminder [sl:person_reminded me me ] ]
events going on in new york this week	[in:get_event [sl:location new york ] [sl:method_timer this week ] ]
2 pm weather please	[in:get_weather [sl:period 2 pm ] ]
bring up when i made my last call to daniel	[in:get_call_time [sl:contact daniel daniel ] ]
is my children online	[in:get_availability [sl:contact [in:get_location [sl:contact my my ] ] ]
do i know anyone who went to ub ?	[in:get_contact [sl:contact_related i i ] [in:pause_music ub ub ] ]
could you please find what the weather is for south australia ?	[in:get_weather [sl:contact south australia ] ]
remind me to pick up my packages on tuesday	[in:create_reminder [sl:person_reminded me me ] [sl:todo pick packages ] [sl:period on tuesday ] ]
set a ' time for bed ' alarm for this evening at 8 o'clock	[in:create_alarm [sl:alarm_name bed bed ] [sl:period for o'clock ] ]
call tatum floyd whatsapp	[in:create_call [sl:contact tatum floyd ] [sl:name_app whatsapp whatsapp ] ] [in:get_employer
pause timer so that i can take a break .	[sl:news_reference [sl:method_timer timer timer ] ]
could you set the alarm for 3 pm , please .	[in:create_alarm [sl:period for pm ] ]
remind me to file all paperwork this sunday .	[in:create_reminder [sl:person_reminded me me ] [sl:todo file paperwork ] [sl:period this sunday ] ]
anyone i know who graduated from ucf in orlando ?	[in:get_contact [sl:contact_related i i ] [sl:school ucf orlando ] ]
play some jazz .	[in:play_music [sl:contact_related jazz jazz ] ]
cancel my reminder to buy milk	[sl:amount [sl:person_reminded my my ] [sl:todo buy milk ] ]
send a video to veronica	[in:send_message [sl:type_content video video ] [sl:contact veronica veronica ] ]
i want to hear that last song again	[sl:contact_method last ]
delete the reminder to walk the dog on sunday	[in:delete_reminder [sl:todo walk dog ] [sl:period on sunday ] ]
make an event reminder for dad 's retirement party next month .	[in:create_reminder [sl:todo dad party ] [sl:period next month ] ]
hey bot can you tell me the weather for new york america	[sl:todo new america ] ]
do i have a friend that works in los angeles ?	[in:get_contact [sl:contact_related i i ] [sl:type_relation friend friend ] [sl:employer los angeles ] ]
start an video call with productivity	[in:create_call [sl:contact_added productivity productivity ] ]
what is michelle 's work address in boise ?	[in:get_location [sl:contact michelle michelle ] [sl:employer boise boise ] ]
set my alarm for 4 : 30 tomorrow morning	[in:create_alarm [sl:period for morning ] ]
restart and play some happy music	[in:update_method_call [sl:music_playlist_title happy happy ] [sl:music_type music music ] ]
how many people were injured in virginia this weekend ?	[in:get_event_attendee [sl:news_topic people virginia ] [sl:date_time this weekend ] ]
anything happening in new york next weekend	[in:get_event [sl:location new york ] [sl:period next weekend ] ]
please change my reminders next week to the week after .	[in:update_reminder_date_time [sl:person_reminded my my ] [sl:date_time next week ] [sl:method_timer after after ] ]
delete the reminder to pick up groceries tonight	[in:delete_reminder [sl:todo pick groceries ] [sl:period tonight tonight ] ]
i need to know cory brumfield 's twitch username	[in:get_call_contact [sl:contact cory brumfield ] ]
make a group call for the family reunion please	[in:create_call [sl:employer family reunion ] ]
set up a reminder 30 minutes before my 2 pm meeting so i can prepare	[in:create_reminder [sl:date_time 30 before ] [sl:todo [in:get_todo [sl:todo my my ] [sl:date_time 2 pm ] [sl:todo meeting meeting ] ] ] ]
open google play music and play green day	[in:play_music [sl:music_provider_name google music ] [sl:music_genre green day ] ]
this is a good song on spotify , what is it ?	[in:get_track_info_music [sl:music_type song song ] [sl:music_provider_name spotify spotify ] ]
hang up on hayes	[in:delete_alarm [sl:alarm_name hayes hayes ] ]
missed calls for today . now .	[in:create_call [sl:date_time for today ] ]
add curtis to this current call .	[in:update_call [sl:recipes_attribute curtis curtis ] ]
add another timer , this time make it for 45 minutes	[in:add_time_timer [sl:method_timer timer timer ] [sl:date_time for minutes ] ]
how many degrees is it using kelvin	[in:get_weather [sl:weather_attribute kelvin kelvin ] ]
play top country songs of all time .	[in:play_music [sl:contact_related country country ] [sl:music_type songs songs ] ]
business news , please	[in:get_stories_news [sl:recipes_diet business business ] [sl:news_type news news ] ]
only use apple as my music app	[in:update_call [sl:music_provider_name apple apple ] ]
remind jerry about his grandmother 's birthday next week	[in:create_reminder [sl:person_reminded jerry jerry ] [sl:todo his birthday ] [sl:date_time next week ] ]
are there any reminders this week for meetings with the school officials	[in:get_reminder [sl:date_time this week ] [sl:person_reminded the week ] [sl:todo [in:get_todo [sl:todo meetings meetings ] [sl:attendee the officials ] ] ] ]
set an alarm for 10 pm sunday , monday , & tuesday .	[in:create_alarm [sl:method_timer [sl:date_time for tuesday ] ]
message brain and tell him that the paperwork for the smith house is needed .	[in:send_message [sl:recipient brain brain ] [sl:method_message the house ] ]
what is the low temp supposed to be tonight ?	[in:get_weather [sl:period tonight tonight ] ]
what is todays uv index ?	[in:get_weather [sl:period todays todays ] [sl:weather_attribute uv index ] ]
what 's happening this weekend in san diego	[in:get_event [sl:period this weekend ] [sl:location san diego ] ]
what ingredients go into a chocolate chip cookie	[in:get_info_recipes [sl:recipes_attribute ingredients ingredients ] [sl:recipes_included_ingredient chocolate cookie ] ]
what is the weather forecast for philly tonight ?	[in:get_weather [sl:location philly philly ] [sl:period tonight tonight ] ]
is cheese vegetarian	[in:is_true_recipes [sl:recipes_dish cheese vegetarian ] ]
can i get a weather update for tonight	[in:get_weather [sl:date_time tonight tonight ] ]
play old thing back ( feat . ja rule and ralph tresvant ) on iheartradio	[in:play_music [in:question_music [sl:music_track_title old ) ] [sl:music_provider_name iheartradio iheartradio ] ]
remind me to send matt 's stamps tomorrow .	[in:create_reminder [sl:person_reminded me me ] [sl:todo send stamps ] [sl:period tomorrow tomorrow ] ]
can you record a video message for ronna grew	[in:send_message [sl:type_content video video ] [sl:recipient ronna ronna ] ]
how long should you cook a 20 pound turkey	[in:get_info_recipes [sl:recipes_attribute how long ] [sl:recipes_qualifier_nutrition 20 pound ] [sl:recipes_unit_measurement pound pound ] [sl:recipes_included_ingredient turkey turkey ] ]
please play zedd 's last album	[in:play_music [in:play_music [sl:music_artist_name zedd zedd ] [sl:music_type album album ] ]
play the chainsmokers	[in:play_music [sl:music_playlist_title the chainsmokers ] ]
is ups still andrews employer	[in:get_employer [sl:contact ups ups ] ]
did i remember to video call john today ?	[in:get_call [sl:contact john john ] ]
play 80 ' s country music	[in:play_music [sl:music_genre country 80 ] [sl:music_genre country country ] [sl:music_type music music ] ]
erase the current logs on the timer	[in:delete_timer [sl:method_timer logs logs ] ]
is there a storm expected in tahoe tomorrow ?	[in:get_weather [sl:weather_attribute storm storm ] [sl:location tahoe tahoe ] [sl:period tomorrow tomorrow ] ]
read me sports headlines	[in:get_stories_news [sl:recipes_unit_measurement sports sports ] [sl:news_type headlines headlines ] ]
turkey important news please	[in:get_stories_news [sl:recipes_included_ingredient turkey turkey ] ]
can you leave thea ludovici a video recording for now	[in:send_message [sl:recipient thea ludovici ] [sl:recipes_meal video video ] ]
video message kamila	[in:send_message [sl:recipes_meal video video ] [sl:recipient kamila kamila ] ]
how many cups of flour should i put in this cake	[in:get_info_recipes [sl:recipes_attribute how many ] [sl:recipes_unit_measurement cups cups ] [sl:recipes_included_ingredient flour flour ] [sl:recipes_included_ingredient cake cake ] ]
message my family asking what restaurant are we eating at or dinner tonight	[in:send_message [sl:recipient [in:get_contact [in:get_event [sl:contact_related my my ] [sl:type_relation family family ] ] ] [sl:content_exact what tonight ] ]
play me jimmy buffett 's greatest hits	[in:play_music [sl:music_artist_name jimmy buffett ] [sl:music_album_modifier greatest hits ] ]
today 's current news	[in:get_stories_news [sl:date_time today current ] [sl:news_type news news ] ]
resume the timer in 18 minutes	[in:resume_timer [sl:date_time in minutes ] ]
please set me to unavailable	[in:set_unavailable ] [in:silence_alarm
will it be above 64 in degrees fahrenheit in tokyo	[in:get_weather [sl:weather_attribute above above ] [sl:weather_attribute 64 64 ] [sl:recipes_diet fahrenheit fahrenheit ] [sl:location tokyo tokyo ] ]
create a reminder to pick up the dry cleaning tomorrow .	[in:create_reminder [sl:todo pick cleaning ] [sl:period tomorrow tomorrow ] ]
how 's the weather ?	[in:get_weather ] ]
remind me to call mom at 7	[in:create_reminder [sl:person_reminded me me ] [sl:todo [in:create_call [sl:contact [in:get_contact [sl:type_relation mom mom ] ] ] ] ] [sl:period at 7 ] ]
i need all reminders from walker .	[in:get_reminder [sl:amount all all ] [sl:person_reminded i i ] ]
how hot did it get yesterday	[in:get_weather [sl:weather_attribute hot hot ] [sl:method_timer yesterday yesterday ] ]
i want to call 555 - 9463 from pixel	[in:create_call [sl:type_contact 555 9463 ] ]
what ingredients are in chicken marsala	[in:get_info_recipes [sl:recipes_attribute ingredients ingredients ] [sl:group chicken marsala ] ]
how to make arab tahini sauce	[in:get_recipes [sl:recipes_included_ingredient arab sauce ] [sl:recipes_dish sauce sauce ] ]
i would like to message ned on messenger that sounds good	[in:send_message [sl:recipient ned ned ] [sl:content_exact sounds good ] ]
please send the ping pong club group	[in:get_recipes [sl:group ping club ] ]
send this video message to john on christmas day .	[in:send_message [sl:type_content video video ] [sl:recipient john john ] [sl:date_time on day ] ]
is it going to be sunny all week ?	[in:get_weather [sl:weather_attribute sunny sunny ] [sl:method_timer all week ] ]
who works at the mcdonald 's on oregon pike ?	[in:get_contact [sl:employer mcdonald mcdonald ] ]
can you tell me who is online ?	[in:get_availability ] ]
set the timer for 48 hours	[in:create_timer [sl:date_time for hours ] [sl:method_timer timer timer ] ]
link mom to the current active call	[in:update_call [sl:recipes_attribute the current ] [sl:contact_added [in:get_contact [sl:type_relation mom mom ] ] ] ]
does milk tea need sugar at all	[in:is_true_recipes [sl:recipes_included_ingredient milk milk ] [sl:amount all all ] [sl:recipes_included_ingredient sugar sugar ] ]
i need the addess to tony 's house	[in:is_true_recipes [sl:recipes_dish tony house ] ]
delete my timers	[in:delete_timer [sl:amount [sl:recipient my my ] [sl:method_timer timers timers ] ]
please play 80s music .	[in:play_music [sl:music_playlist_title 80s 80s ] [sl:music_type music music ] ]
can we expect sunshine today ?	[in:get_weather [sl:weather_attribute sunshine sunshine ] [sl:period today today ] ]
set the alarm for 10 mins .	[in:create_alarm [sl:period the mins ] ]
delete all my reminders for tuesday .	[in:delete_reminder [sl:amount all all ] [sl:person_reminded my my ] [sl:method_timer for tuesday ] ]
send a video call to my family .	[in:send_message [sl:recipient [in:get_contact [sl:contact_related my my ] [sl:type_relation family family ] ] ] ]
delete all work reminders	[in:delete_reminder [sl:amount all all ] [sl:todo work work ] ] [in:delete_playlist_music
find me something to do	[in:get_event ] ]
read all my unread messages .	[in:get_reminder [sl:method_retrieval_reminder read read ] [sl:amount all all ] ]
share this book event with jared	[in:share_event [sl:ordinal book book ] [sl:contact jared jared ] ]
can use please use whatsapp to call antonio munoz	[in:create_call [sl:music_provider_name whatsapp whatsapp ] [sl:contact antonio munoz ] ]
dial susie also	[in:end_call [sl:contact susie susie ] ]
can you remind me to call kaz after dinner	[in:create_reminder [sl:person_reminded me me ] [sl:todo [in:get_todo [sl:todo [in:create_call [sl:contact kaz kaz ] ] ] ] [sl:todo after dinner ] ] ]
make a reminder for my doctor 's appointment .	[in:create_reminder [sl:recipes_included_ingredient my appointment ] ]
remind me that the cable guy will be out to fix the cable today at 4 pm .	[in:create_reminder [sl:person_reminded me me ] [sl:todo the cable ] [sl:period today pm ] ]
things to do this weekend	[in:get_event [sl:period this weekend ] ]
call cleveland clinic 's help line	[in:create_call [sl:group cleveland clinic ] ]
remind me to send the finished code to josh by the end of the day on friday .	[in:create_reminder [sl:person_reminded me me ] [sl:todo send josh ] [sl:period by friday ] ]
how many calories are in an egg	[in:get_info_recipes [sl:recipes_attribute how many ] [sl:recipes_unit_nutrition calories calories ] [sl:recipes_dish egg egg ] ]
call tori bortle ' s grandmother	[in:create_call [sl:contact [in:get_contact [sl:category_event tori bortle ] [sl:type_relation grandmother grandmother ] ] ] ]
ending call	[sl:date_time [in:end_call ]
remind me to call my mother	[in:create_reminder [sl:person_reminded me me ] [sl:todo [in:create_call [sl:contact [in:get_contact [sl:contact_related my my ] [sl:type_relation mother mother ] ] ] ] ]
i want an alarm time of 6 am	[in:get_alarm [sl:date_time 6 am ] ]
when is she graduating from csu	[in:get_education_time [sl:type_relation she she ] [sl:life_event graduating graduating ] [sl:school csu csu ] ]
what is the temperature going to be tomorrow	[in:get_weather [sl:period tomorrow tomorrow ] ]
temperature today	[in:get_weather [sl:period today today ] ]
create call for me aurora , francesca , and cristian long	[in:answer_call [sl:contact aurora aurora ] [sl:contact francesca francesca ] ]
what reminders do i have set up for next week thursday morning ?	[in:get_reminder [sl:person_reminded i i ] [sl:period for morning ] ]
what are the day before yesterday 's headlines	[in:get_stories_news [sl:date_time day before ] [sl:news_type headlines headlines ] ]
start a video message	[in:send_message [in:get_message_contact [sl:type_content video video ] ]
who sings the song ashes to ashes	[in:play_music [sl:music_type song song ] [sl:music_track_title ashes ashes ] ]
is it going to be cloudy at all today ?	[in:get_weather [sl:weather_attribute cloudy cloudy ] [sl:date_time at today ] ]
remind me to pick up jake at 3	[in:create_reminder [sl:person_reminded me me ] [sl:todo pick jake ] [sl:period at 3 ] ]
news update on the winter olympics	[in:get_stories_news [sl:news_type news news ] [sl:recipes_excluded_ingredient winter olympics ] ]
how many cups of sugar go in a cake	[in:get_info_recipes [sl:recipes_attribute how many ] [sl:recipes_unit_measurement cups cups ] [sl:recipes_dish sugar sugar ] [sl:recipes_dish cake cake ] ]
let ’s record a video message .	[in:send_message [sl:recipes_meal video video ] ]
please play vybz kartel songs	[in:play_music [sl:music_artist_name vybz kartel ] [sl:music_type songs songs ] ] [in:set_default_provider_music
can we add my cousins to the video chat ?	[sl:contact_added [in:get_contact [sl:contact_related my my ] [sl:type_relation cousins cousins ] ] ]
how many feet of snow are we getting next week ?	[in:get_weather [sl:weather_attribute snow snow ] [sl:period next week ] ]
can i video message finn	[in:send_message [in:get_message_contact [sl:type_content video video ] [sl:recipient finn finn ] ]
make a call to dakota stephens 's mother	[in:create_call [sl:contact [in:get_contact [sl:category_event dakota stephens ] [sl:type_relation mother mother ] ] ] ]
which family member is from sacramento .	[in:get_contact [sl:type_relation family family ] [sl:weather_attribute sacramento sacramento ] ]
what time is the tropical storm scheduled to reach florida ?	[in:get_weather [sl:alarm_name tropical florida ] ]
does joe work at olive garden ?	[in:get_job [sl:contact joe joe ] [sl:employer olive garden ] ]
remind me to go to school open house thursday	[in:create_reminder [sl:person_reminded me me ] [sl:todo go house ] [sl:period thursday thursday ] ]
i'd like to call george j rios	[in:create_call [in:create_call [sl:contact george rios ] ] ]
what 's happening in manchester , nh tonight	[in:get_event [sl:location manchester nh ] [sl:method_timer tonight tonight ] ]
anybody i know work at whole food	[in:get_contact [sl:contact_related i i ] [sl:school whole food ] ]
anything fun to do tomorrow night	[in:get_event [sl:period tomorrow night ] ]
remind me to create a template for work by wednesday .	[in:create_reminder [sl:person_reminded me me ] [sl:todo create work ] [sl:period by wednesday ] ]
what can i do in fairfax tomorrow	[in:get_event [sl:location fairfax fairfax ] [sl:method_timer tomorrow tomorrow ] ]
make my alarm ring at 7 am wednesday and friday	[in:create_alarm [sl:period at wednesday ] [sl:date_time friday friday ] ]
what degree did trevor graduate with ?	[in:get_education_degree [sl:contact trevor trevor ] [in:switch_call [sl:contact trevor trevor ] ]
who is playing this song ?	[sl:music_album_title [sl:music_type song song ] ]
cancel my reminder to call john tomorrow	[sl:amount [in:create_reminder [sl:person_reminded my my ] [sl:todo [in:create_call [sl:contact john john ] ] ] [sl:date_time tomorrow tomorrow ] ]
let me see video messages from my partner tucker	[in:get_message [sl:job video video ] [sl:sender [in:get_contact [sl:contact_related my my ] [sl:type_relation partner partner ] [sl:contact tucker tucker ] ] ] ]
what 's in curry	[in:get_info_recipes [sl:location curry curry ] ]
who went to ocu ?	[in:get_contact [sl:news_type went went ] ]
is it around 33 in degrees celcius london next week	[sl:weather_attribute around around ] [sl:weather_attribute 33 33 ] [sl:weather_temperature_unit celcius celcius ] [sl:location london london ] [sl:date_time next week ] ]
can you play some radiohead music on spotify please	[in:play_music [sl:music_type radiohead music ] [sl:music_provider_name spotify spotify ] ]
call setsuko leichner ' s kid	[in:create_call [sl:contact [in:get_contact [sl:category_event setsuko leichner ] [sl:type_relation kid kid ] ] ] ]
concerts in nyc next weekend	[in:get_event [sl:category_event concerts concerts ] [sl:location nyc nyc ] [sl:period next weekend ] ]
details on the hurricane that hit florida	[in:get_stories_news [sl:news_type details details ] [sl:alarm_name hurricane florida ] ]
what 's the latest news on oj simpson ?	[in:get_stories_news [sl:method_timer latest latest ] [sl:news_type news news ] [sl:news_topic oj simpson ] ]
show selma 's friends	[in:get_contact [in:get_event [sl:contact_related selma selma ] [sl:type_relation friends friends ] ]
please give me the local news .	[sl:music_type news news ]
is eileen online now ?	[in:get_availability [sl:contact eileen eileen ] ] [in:get_employer
how many inches of snow is predicted for thursday ?	[in:get_weather [sl:weather_attribute snow snow ] [sl:period for thursday ] ]
i want to listen to pop music	[in:play_music [sl:contact_related pop pop ] [sl:music_type music music ] ]
what is george 's home address ?	[in:get_location [sl:contact george george ] ] [in:set_rsvp_yes
put in a reminder to meet my mother on eastern parkway this thursday .	[in:create_reminder [sl:todo meet parkway ] [sl:period this thursday ] ]
show me reminders i have for work meetings next week	[in:get_reminder [sl:method_retrieval_reminder show show ] [sl:person_reminded i i ] [sl:alarm_name work meetings ] [sl:date_time next week ] ]
play george michael songs	[in:play_music [sl:music_artist_name george michael ] [sl:music_type songs songs ] ] [in:set_default_provider_music
what will mauritius weather forecast be over new year ?	[in:get_weather [sl:news_topic mauritius mauritius ] [sl:date_time over year ] ]
what was the biggest news story yesterday ?	[in:get_stories_news [sl:news_type news story ] [sl:period yesterday yesterday ] ]
what is happening on thursday	[in:get_event [sl:period on thursday ] ]
do chocolate chip cookies require light brown or dark brown sugar	[in:is_true_recipes [sl:recipes_included_ingredient chocolate cookies ] [sl:recipes_included_ingredient dark sugar ] ]
change power nap timer to 25 minutes	[in:update_timer [sl:timer_name power nap ] [sl:date_time to minutes ] ]
play christian rap	[in:play_music [sl:music_artist_name christian rap ] ]
what temp to cook meatloaf	[in:get_info_recipes [sl:recipes_attribute temp temp ] [sl:recipes_included_ingredient meatloaf meatloaf ] ]
delete all the reminders about the collective radio network board meetings .	[in:delete_reminder [sl:amount all all ] [sl:todo the meetings ] ]
typical weather for ohio	[in:get_weather [sl:alarm_name ohio ohio ] ]
will it storm tomorrow	[in:get_weather [sl:weather_attribute storm storm ] [sl:period tomorrow tomorrow ] ]
is there a state of the union address tonight	[in:get_location [sl:employer state union ] [sl:date_time tonight tonight ] ]
can you tell me when my next alarm is ?	[in:get_alarm [sl:recipes_attribute next next ] ]
set up an alarm for today at 7 pm	[in:create_alarm [sl:period for pm ] ]
add buy maggie a birthday gift to today 's reminder .	[in:update_reminder_todo [sl:todo buy gift ] [sl:date_time to today ] ]
any concerts in philadelphia next weekend	[in:get_event [sl:category_event concerts concerts ] [sl:location philadelphia philadelphia ] [sl:method_timer next weekend ] ]
show me the earliest family meeting reunion reminder .	[in:get_reminder [sl:method_retrieval_reminder show show ] [sl:person_reminded me me ] [sl:date_time earliest earliest ] ]
how to prevent cheesecake cracks	[in:get_info_recipes [sl:recipes_attribute how prevent ] [sl:recipes_dish cheesecake cracks ] ]
add 5 minutes to run timer	[in:add_time_timer [sl:date_time 5 minutes ] [sl:date_time timer timer ] ]
set schedule to available	[in:rewind_music ]
make this voice call a video call	[in:update_method_call ] [in:stop_music
recipes with beans	[in:get_recipes [sl:recipes_dish beans beans ] ]
please call rebecca , rene , heather , and alison	[in:create_call [sl:contact rebecca rebecca ] [sl:contact heather rene ] [sl:contact alison alison ] [sl:contact alison alison ] [sl:contact alison alison ] ]
add 2 more minutes to this timer	[in:add_time_timer [sl:date_time 2 minutes ] [sl:date_time timer timer ] ]
hang up line	[in:silence_alarm ]
what is the temperature in yucaipa today ?	[in:get_weather [sl:weather_temperature_unit yucaipa yucaipa ] [sl:date_time today today ] ]
whats the calorie count for a marsala sauce ?	[in:get_info_recipes [sl:recipes_unit_nutrition calorie calorie ] [sl:recipes_included_ingredient marsala sauce ] ]
remind me of how much time is left after 10 minutes	[in:create_reminder [sl:person_reminded me me ] [sl:todo how minutes ] ]
turn the music off	[in:silence_alarm [sl:music_type music music ] ]
what is the weather outside	[in:get_weather ] ]
what kind of weather should i expect for next week ?	[in:get_weather [sl:period for week ] ]
start calling grandpa	[in:create_call [in:create_call [sl:contact [in:get_contact [sl:type_relation grandpa grandpa ] ] ] ] ]
not going to feast of san gennaro	[sl:recipes_excluded_ingredient [in:set_rsvp_no [sl:title_event feast gennaro ] ]
ask casey how many performers are going to be at the show tonight	[in:send_message [sl:recipient casey casey ] [sl:recipes_unit_measurement how tonight ] ]
tell me what the weather forecast is on monday	[in:get_weather [sl:period on monday ] ]
change my reminder alarm .	[in:update_alarm [sl:ordinal reminder reminder ] ]
is there any news news about president trump ?	[in:get_stories_news [sl:news_type news news ] [sl:news_topic president trump ] ]
i would like to message filby and jake	[in:get_message [sl:recipient filby filby ] [sl:recipient jake jake ] ]
call ella and juliana	[in:update_call [sl:contact_added ella ella ] [sl:contact juliana juliana ] ]
remind dad to pick up 6 lobsters for the clambake .	[in:create_reminder [sl:person_reminded [sl:type_relation dad dad ] ] [sl:todo pick clambake ] ]
can you play me nf 's first album ?	[in:play_music [sl:music_playlist_title nf nf ] [sl:music_type album album ] ]
what soccer games are going on friday	[in:get_event [sl:category_event soccer games ] [sl:method_timer friday friday ] ]
cancel all of my reminders for next friday after 2 : 00 pm .	[in:delete_reminder [sl:amount all all ] [sl:person_reminded my my ] [sl:method_timer for pm ] ]
remind me to check - in with susan friday .	[in:create_reminder [sl:person_reminded me me ] [sl:todo [in:get_todo [sl:todo check in ] [sl:attendee susan susan ] ] ] [sl:method_timer friday friday ] ]
yeah , send this video to jimbob	[in:get_info_contact [sl:music_type video video ] [sl:contact jimbob jimbob ] ]
i'd like to touch base with arthur	[in:create_call [sl:contact arthur arthur ] ] [in:silence_alarm
should i bring an umbrella today ?	[in:get_weather [sl:weather_attribute umbrella umbrella ] [sl:period today today ] ]
what is a good recipe for fish and chips	[in:get_recipes [sl:recipes_rating good good ] [sl:recipes_included_ingredient fish fish ] [sl:recipes_dish fish chips ] ]
start group call	[in:end_call ]
this weeks weather for waikiki , hawaii ?	[in:get_weather [sl:period this weeks ] [sl:location waikiki hawaii ] ]
tell me who is working at burger king	[sl:recipient [in:get_contact [sl:employer burger king ] ]
wake me up at 7 am on the 2nd	[in:create_alarm [sl:method_timer [sl:date_time at 2nd ] ]
is aaron a friend of lili ?	[in:get_contact [sl:contact aaron aaron ] [sl:type_relation friend friend ] [sl:contact lili lili ] ]
is it snowing in chicago ?	[in:get_weather [sl:weather_attribute snowing snowing ] [sl:alarm_name chicago chicago ] ]
can you get some more events like this please ?	[in:get_reminder ]
create a playlist with my rock songs	[in:create_playlist_music [sl:music_type playlist playlist ] [sl:music_artist_name rock rock ] [sl:music_type songs songs ] ]
whats the high for the next 3 days ?	[in:get_weather [sl:period for days ] ]
what ingredients are needed for meatloaf	[in:get_info_recipes [sl:amount ingredients ingredients ] [sl:recipes_dish meatloaf meatloaf ] ]
any storms today	[in:get_weather [sl:weather_attribute storms storms ] [sl:method_timer today today ] ]
i don't want to forget to eat my lunch	[sl:amount i i ]
remind me to call grandma at 7 pm .	[in:create_reminder [sl:person_reminded me me ] [sl:todo [in:create_call [sl:contact [in:get_contact [sl:type_relation grandma grandma ] ] ] ] ] [sl:method_timer at pm ] ]
set a timer for 25 minutes for the brownies .	[in:create_timer [sl:date_time for minutes ] [sl:method_timer brownies brownies ] ]
do i have any video call tonight with donny ?	[in:get_call ]
remind me to call my wife when i leave work	[in:create_reminder [sl:person_reminded me me ] [sl:todo [in:get_todo [sl:todo [in:create_call [sl:contact [in:get_contact [sl:contact_related my my ] [sl:type_relation wife wife ] ] ] ] ] [sl:location [in:get_location ] ] ] ] ]
delete the reminder for otis to walk the dog tomorrow at 8 pm .	[in:delete_reminder [sl:person_reminded otis otis ] [sl:todo walk dog ] [sl:period tomorrow pm ] ]
put in glenda to this call	[in:end_call [sl:contact glenda glenda ] ]
is bill still employed at citizen 's bank	[in:get_undergrad [sl:contact bill bill ] [sl:employer citizen bank ] ]
tell me what the weather will be this evening .	[in:get_weather [sl:method_timer this evening ] ]
set a reminder for 8 pm	[in:create_reminder [sl:period for pm ] ]
can you tell me the headlines ?	[sl:music_type headlines headlines ]
repeat my timer	[in:create_timer [sl:method_timer timer timer ] ]
for music use google play	[in:stop_music [sl:music_provider_name google play ] ]
musical events today	[in:get_event [sl:category_event musical musical ] [sl:period today today ] ]
tell me leslie 's friends	[in:get_contact [in:get_event [sl:contact_related leslie leslie ] [sl:type_relation friends friends ] ]
add david to phone call .	[in:update_call [sl:recipes_attribute david david ] ]
set alarm to sunrise tomorrow	[in:snooze_alarm [sl:date_time tomorrow tomorrow ] ]
what friends of mine are online ?	[in:get_mutual_friends [sl:type_relation friends friends ] [sl:contact_related mine mine ] [sl:contact_method ]
how long does the times have left ?	[in:get_timer [sl:ordinal ]
who is sally 's teacher ?	[in:get_employer [sl:contact sally sally ] ]
is levi online ?	[in:get_availability [sl:contact levi levi ] ] [in:get_employer
friends of jolene ?	[sl:contact [in:get_contact [sl:type_relation friends friends ] [sl:contact_related jolene jolene ] ] ]
what are the top news stories in science	[in:get_stories_news [sl:news_reference top top ] [sl:news_type news stories ] [sl:recipes_diet science science ] ]
fast forward	[in:fast_forward_music [sl:music_rewind_time ]
does homero work at a college ?	[in:get_undergrad [sl:contact homero homero ] ]
set an alarm for 7 : 30 p.m	[in:create_alarm [sl:period for p.m ] ]
who texted me ?	[in:update_reminder [sl:person_reminded me me ] ]
message robbie that 's good .	[in:send_message [sl:recipient robbie robbie ] [sl:method_message good good ] ]
snooze my alarm for 10 minutes	[in:snooze_alarm [sl:period for minutes ] ]
play some alternative music	[in:play_music [sl:weather_attribute alternative alternative ] [sl:music_type music music ] ]
call dorathy jon postemski ' s uncle	[in:create_call [sl:contact [in:get_contact [sl:category_event dorathy postemski ] [sl:type_relation uncle uncle ] ] ] ]
add jason to the call too	[in:update_call [sl:contact_removed jason jason ] ]
message debra and let her know we will not be able to attend her hairstyle debut for her cosmetology school next thursday .	[in:send_message [sl:recipient debra debra ] [sl:recipes_type we thursday ] ]
what can i do on friday night	[in:get_event [sl:period on night ] ]
whats new in santa clarita	[in:get_info_recipes [sl:recipes_dish santa clarita ] ]
what is local news	[sl:type_content [in:get_stories_news [sl:news_category local local ] [sl:news_type news news ] ]
dm my husband that i'm on my way .	[in:create_reminder [sl:person_reminded [in:get_contact [sl:contact_related my my ] [sl:type_relation husband husband ] ] ] [sl:content_exact i'm way ] ]
what is the address to scotty 's school ?	[in:get_location [sl:location scotty scotty ] ]
remind me to pick up pizza and coke for dinner .	[in:create_reminder [sl:person_reminded me me ] [sl:todo pick dinner ] [sl:todo dinner dinner ] ]
how do you cook spaghetti	[in:get_recipes [sl:recipes_included_ingredient spaghetti spaghetti ] ]
who is free to talk	[in:set_available ]
set a new alarm for 1st june at 9 : 45 am please	[in:create_alarm [sl:period for am ] ]
how do you make noodles from a zucchini	[in:get_recipes [sl:recipes_dish noodles noodles ] [sl:recipes_dish zucchini zucchini ] ]
hold on the video call	[in:switch_call ]
what is fun to do this weekend	[in:get_event [sl:period this weekend ] ]
find cnn article on voting restrictions	[in:get_stories_news [sl:news_source cnn cnn ] [sl:news_type article article ] [sl:recipes_excluded_ingredient voting restrictions ] ]
timer almost over	[in:resume_timer [sl:method_timer timer timer ] ]
ask lynn if she can look into getting tickets for the burgerbash event at the golden nugget next month	[in:send_message [sl:recipient lynn lynn ] [sl:recipes_type she month ] ]
set up ' medicine ' alarm for 4 pm	[in:create_alarm [sl:alarm_name medicine medicine ] [sl:period for pm ] ]
new call , dial kyle	[in:end_call [sl:contact kyle kyle ] ]
lunch break is 15 minutes , set timer	[in:create_timer [sl:date_time 15 minutes ] [sl:date_time 15 minutes ] [sl:method_timer timer timer ] ]
stop this song	[in:stop_music [sl:music_type song song ] ]
what is the temperature in newcastle ?	[in:get_weather [sl:alarm_name newcastle newcastle ] ]
dial mom	[in:create_call [in:create_call [sl:contact [in:get_contact [sl:type_relation mom mom ] ] ] ] ]
create reminder to file my taxes before 3 pm .	[in:create_reminder [sl:person_reminded my my ] [sl:todo file taxes ] [sl:date_time before pm ] ]
send that facebook message	[in:send_message [sl:name_app facebook facebook ] ] ]
i want some new age music	[sl:music_artist_name new age ] [sl:music_type music music ] ]
remind me to call grandma on friday	[in:create_reminder [sl:person_reminded me me ] [sl:todo [in:create_call [sl:contact [in:get_contact [sl:type_relation grandma grandma ] ] ] ] ] [sl:period on friday ] ]
remove my brother from this call	[in:update_call [in:reply_message [sl:contact_removed [in:get_contact [sl:contact_related my my ] [sl:type_relation brother brother ] ] ] ]
update my wakeup alarm to 5 am	[in:update_alarm [sl:alarm_name wakeup wakeup ] [sl:period to am ] ]
things to do in rochester this week	[in:get_event [sl:location rochester rochester ] [in:set_unavailable ]
set a reminder to send a gift from edible arrangements for sammie and wiff on august 4th at 8 am .	[in:create_reminder [sl:todo send arrangements ] [sl:person_reminded wiff wiff ] ]
top three local headlines please	[in:get_stories_news [sl:news_reference top top ] [sl:recipes_unit_measurement local local ] [sl:news_type headlines headlines ] ]
car shows happening soon	[in:get_event [sl:contact_related car shows ] ]
are there any fun things to do this week	[in:get_event [sl:period this week ] ]
anything cool happening in my area today	[in:get_event [sl:location my my ] [sl:location [in:get_location ] ] [sl:date_time today today ] ]
is it hot in cancun	[in:get_weather [sl:weather_attribute hot hot ] [sl:location cancun cancun ] ]
play some country music please .	[in:play_music [sl:weather_attribute country country ] [sl:music_type music music ] ]
latest breaking news	[in:get_stories_news [sl:date_time latest latest ] [sl:recipes_excluded_ingredient breaking breaking ] [sl:news_type news news ] ]
what friends have birthdays in june ?	[in:get_contact [sl:type_relation friends friends ] [sl:method_timer [sl:date_time in june ] ]
remind me to pick up my dry cleaning	[sl:recipes_attribute pick cleaning ]
please display all of my the reminders for my wife and i	[in:get_reminder [sl:method_retrieval_reminder display display ] [sl:amount all all ] [sl:person_reminded my my ] [sl:todo my i ] ]
i want a good recipe for cole slaw	[in:get_recipes [sl:recipes_rating good good ] [sl:location cole slaw ] ]
go to track 3 please	[in:replay_music [sl:music_type track track ] ]
what the top story from the new york times ?	[in:get_stories_news [sl:news_reference top top ] [sl:news_type story story ] [sl:attendee_event the times ] ]
how long should i boil corn on the cob	[in:get_info_recipes [sl:recipes_attribute how long ] [sl:recipes_cooking_method boil boil ] [sl:recipes_dish corn cob ] ]
what is the best way to cook chicken breasts to ensure they aren't dry	[in:get_info_recipes [sl:recipes_attribute best best ] [sl:recipes_included_ingredient chicken breasts ] [sl:recipes_cooking_method aren't dry ] ]
how long do i need to cook ground beef for	[in:get_info_recipes [sl:recipes_attribute how long ] [sl:recipes_dish ground beef ] ]
please tell me the new york weather forecast	[in:get_weather [sl:alarm_name new york ] ]
read me the news headlines	[sl:music_type news headlines ] ]
call judy collins	[in:create_call [sl:contact judy collins ] ] [in:set_default_provider_music
i'm baking cookies in the oven , can you remind me to take them out in 25 minutes ?	[in:create_reminder [sl:todo [in:get_todo [sl:todo baking cookies ] ] [sl:person_reminded me me ] [sl:todo take out ] ] [sl:date_time in minutes ] ]
play ed sheeran new album	[in:play_music [sl:music_artist_name ed sheeran ] [sl:music_type album album ] ] [in:set_default_provider_music
how 's the weather this weekend ?	[in:get_weather [sl:period this weekend ] ]
how hot is it for san francisco next week degrees c	[in:get_weather [sl:weather_attribute hot hot ] [sl:location san francisco ] [sl:period next week ]
does larry live in san leandro ?	[in:get_location [sl:contact larry larry ] [sl:contact san leandro ] ]
recent news on los angels crimes	[in:get_stories_news [sl:period recent recent ] [sl:news_type news news ] [sl:news_topic los crimes ] ]
remind me on october 5th to make hotel reservations for the trip .	[in:create_reminder [sl:person_reminded me me ] [sl:period on 5th ] [sl:todo make trip ] ]
get me my friend walker	[in:get_contact [sl:contact_related my my ] [sl:type_relation friend friend ] [sl:contact walker walker ] ]
give me an update on the flooding in houston	[in:get_stories_news [sl:news_type flooding update ] [sl:news_topic flooding houston ] ]
is it raining by my office	[in:get_weather [sl:alarm_name raining raining ] ]
ingredients to make healthy homemade fries	[in:get_recipes [sl:recipes_attribute healthy healthy ] [sl:recipes_dish fries fries ] ]
please put me as unavailable	[in:set_unavailable ] [in:silence_alarm
find who works at bradesco bank .	[in:get_contact [sl:location bradesco bank ] ]
show me all of the reminders for work this week ?	[in:get_reminder [sl:method_retrieval_reminder show show ] [sl:person_reminded me me ] [sl:amount all all ] [sl:todo work work ] [sl:date_time this week ] ]
what 's the temperature right now ?	[in:get_weather ] ]
change my reminder from tomorrow to , today at 5 pm	[in:update_reminder_date_time [sl:person_reminded my my ] [sl:date_time from tomorrow ] [sl:method_timer , pm ] ]
set a reminder to call uncle anthony tomorrow at 7 pm	[in:create_reminder [sl:todo [in:create_call [sl:contact [in:get_contact [sl:type_relation uncle uncle ] [sl:contact anthony anthony ] ] ] ] ] [sl:method_timer tomorrow pm ] ]
how many zucchini do you need for zucchini bread	[in:get_info_recipes [sl:recipes_attribute how many ] [sl:recipes_dish zucchini bread ] [sl:recipes_dish zucchini bread ] ]
people online .	[in:get_availability ] ]
resume the countdown .	[in:resume_timer [sl:date_time the countdown ] ]
give me the news update for around the world .	[in:get_stories_news [in:get_timer ]
phone my brother paul .	[in:create_call [in:create_call [sl:contact [in:get_contact [sl:contact_related my my ] [sl:type_relation brother brother ] [sl:contact paul paul ] ] ] ]
please snooze my alarm for 20 minutes	[in:snooze_alarm [sl:period for minutes ] ]
remind joe k to call me on the 19th at 7 please	[in:create_reminder [sl:person_reminded joe k ] [sl:todo [in:hold_call [sl:contact me me ] ] [sl:date_time on 7 ] ]
please call 5558168 from iphone	[in:create_call [sl:phone_number 5558168 5558168 ] [sl:name_app iphone iphone ] ]
remind me that school starts wednesday at 9 am	[in:create_reminder [sl:person_reminded me me ] [sl:todo school starts ] [sl:period wednesday am ] ]
call my boyfriend now	[in:create_call [sl:contact [in:get_contact [sl:category_event boyfriend boyfriend ] ] ] ]
can you use messenger to call aviana	[in:create_call [sl:music_provider_name messenger messenger ] [sl:contact aviana aviana ] ]
can you message beth and ask her if she would like a coffee .	[in:send_message [sl:recipient beth beth ] [sl:method_message she coffee ] ]
play my broadway soundtrack playlist	[in:play_music [sl:music_genre broadway broadway ] [sl:music_type soundtrack playlist ] ]
start switch call	[in:end_call ]
message kevin asking if he liked his lunch .	[in:send_message [sl:recipient kevin kevin ] [sl:todo he lunch ] ]
when is the weather going to be much cooler	[in:get_weather [sl:alarm_name cooler cooler ] ]
what is the weather going to be like in cornwall this weekend ?	[in:get_weather [sl:location cornwall cornwall ] [sl:period this weekend ] ]
i want to message carmen	[in:send_message [in:send_message [sl:recipient carmen carmen ] ]
quick and easy recipes	[in:get_recipes [sl:recipes_attribute quick quick ] [sl:recipes_attribute easy easy ] ]
what are the top us news stories today	[in:get_stories_news [sl:news_reference top top ] [sl:news_topic us us ] [sl:news_type news stories ] [sl:period today today ] ]
set a repeating alarm for every wednesday at 6 in the evening .	[in:create_alarm [sl:period for evening ] ]
please set an alarm for 3 : 00 pm every day	[in:create_alarm [sl:period for day ] ]
can you tell me the names of friends who went to san diego university ?	[in:get_contact [sl:type_relation friends friends ] [sl:attendee san university ] ]
what 's the high for tomorrow	[in:get_weather [sl:period for tomorrow ] ]
what are some good chicken meals	[in:get_recipes [sl:recipes_rating good good ] [sl:recipes_included_ingredient chicken chicken ] ]
remind me to call dr . salomn to reschedule appointment .	[in:create_reminder [sl:person_reminded me me ] [sl:todo [in:create_call [sl:contact dr salomn ] ] [sl:todo reschedule appointment ] ] ]
snooze alarm till 8 am .	[in:snooze_alarm [sl:method_timer [sl:date_time till am ] ]
record a video message for my grandmother	[in:send_message [sl:recipes_meal video video ] [sl:recipient [in:get_contact [sl:contact_related my my ] [sl:type_relation grandmother grandmother ] ] ] ]
what are the top news headlines	[in:get_stories_news [sl:recipes_excluded_ingredient news headlines ] ]
fun events in dallas	[in:get_event [sl:alarm_name dallas dallas ] ]
i thought i already set up a reminder for the phone call at 3 , but will you check ?	[in:create_reminder [sl:person_reminded i i ] [sl:todo [in:get_todo [sl:todo the call ] [sl:date_time at 3 ] ] ] [sl:date_time you check ] ]
who 's online for chat tonight ?	[in:get_message_contact [sl:recipient ? tonight ] ]
do i need my umbrella	[in:get_weather [sl:alarm_name umbrella umbrella ] ]
set timer for 20 minutes .	[in:create_timer [sl:date_time for minutes ] [sl:method_timer timer timer ] ]
is it going to be windy on the beach today	[in:get_weather [sl:weather_attribute windy windy ] [sl:location beach beach ] [sl:period today today ] ]
can you call 7105553393 on whatsapp	[in:create_call [in:get_gender [sl:phone_number 7105553393 7105553393 ] [sl:name_app whatsapp whatsapp ] ]
remind me to take an alternate route home from work tonight .	[in:create_reminder [sl:person_reminded me me ] [sl:todo take work ] [sl:location [in:get_location ] ] [sl:date_time tonight tonight ] ]
delete the reminder for my hair appointment	[in:delete_reminder [sl:person_reminded my my ] [sl:todo my appointment ] ]
play more music like this .	[in:play_music [sl:recipes_included_ingredient music music ] ]
remind me to call my wife , so i can change the time of our lunch appointment .	[in:create_reminder [sl:person_reminded me me ] [sl:todo [in:get_todo [sl:todo [in:create_call [sl:contact [in:get_contact [sl:contact_related my my ] [sl:type_relation wife wife ] ] ] ] ] [sl:todo the appointment ] ] ] ]
rewind the song	[in:set_available [sl:music_type song song ] ]
set a birthday reminder for cheys party at six	[in:create_reminder [sl:todo birthday birthday ] [sl:date_time at six ] ]
remind me to work on my 100 list over the weekend	[in:create_reminder [sl:person_reminded me me ] [sl:todo work list ] [sl:period over weekend ] ]
modify my alarm for tomorrow to 8 am	[in:create_alarm [sl:date_time for am ] ]
switch to my favorite new age channel .	[in:play_music [sl:music_playlist_title favorite age ] [sl:music_type channel channel ] ]
when did danielle start at the university of chicago ?	[in:get_education_time [sl:contact danielle danielle ] [sl:employer university chicago ] ]
start alarm for 9 am every sunday biweekly	[in:create_alarm [sl:period for sunday ] ]
replay this song please	[sl:music_type song song ] ]
redial mum 's number	[in:play_music [sl:music_artist_name redial redial ] [sl:type_relation mum mum ] ]
set up a reminder for final project 2 due on august 15th .	[in:create_reminder [sl:todo final due ] [sl:period on 15th ] ]
what 's the weather going to be later on ?	[in:get_weather [sl:period later on ] ]
find fake news	[sl:music_type fake news ]
my friends in ga online	[in:get_availability [sl:contact ga ga ] ]
what time did the sun set on august 5th 1922	[in:get_education_time [sl:date_time on 1922 ] ]
play free fallin ' on iheartradio	[in:play_music [sl:music_artist_name free fallin ] [sl:music_provider_name iheartradio iheartradio ] ]
what languages does putin speak	[in:get_location [sl:contact putin putin ] ]
remind me that gabriella 's school start august 13th .	[in:create_reminder [sl:person_reminded me me ] [sl:todo gabriella school ] [sl:date_time start 13th ] ]
hang up on hope	[in:end_call [sl:location hope hope ] ]
what 's happening in baltimore this weekend	[in:get_event [sl:location baltimore baltimore ] [sl:period this weekend ] ]
start a timer for 21 minutes from now	[in:create_timer [in:create_alarm [sl:method_timer timer timer ] [sl:date_time for now ] ]
show me video messages from my husband	[in:get_message [sl:type_content video video ] [sl:recipient [in:get_contact [sl:contact_related my my [in:like_music [sl:type_relation husband husband ] ] ] ] ]
i would like some instrumental guitar music	[in:play_music [in:create_timer [sl:music_genre instrumental guitar ] [sl:music_type music music ] ]
alexa remind me to book tickets for las vegas hotels in the new year .	[in:create_reminder [sl:person_reminded me me ] [sl:todo book hotels ] [sl:period in year ] ]
set a reminder to wash the dishes at 4 pm	[in:create_reminder [sl:todo wash dishes ] [sl:period at pm ] ]
can you set an alarm for one and a half hours from now	[in:create_alarm [sl:period for hours ] ]
back exercises timer paused .	[in:update_timer [sl:timer_name exercises exercises ] [sl:method_timer timer timer ] ]
has the school thread sent me anything	[in:get_message [sl:sender school school ] [sl:recipient me me ] ]
call yaretzi ' s girlfriend	[in:create_call [sl:contact [in:get_contact [sl:category_event yaretzi yaretzi ] [sl:type_relation girlfriend girlfriend ] ] ] ]
open spotify and play face the sun	[in:play_music [sl:music_provider_name spotify spotify ] [sl:music_album_title face sun ] ]
will i need a rainjacket ?	[in:get_weather [sl:location rainjacket rainjacket ] ]
remind me to mail the thank you cards out monday at 8 am .	[in:create_reminder [sl:person_reminded me me ] [sl:todo mail out ] [sl:period monday am ] ]
how it will be like in portugal next month ?	[in:get_weather [sl:location portugal portugal ] [sl:period next month ] ]
can i go outside and tan	[in:get_weather [sl:weather_attribute tan tan ] ]
are any of my friends online	[in:get_availability ] ]
how many grams of ground beef do i need for hamburger patty	[in:get_info_recipes [sl:recipes_attribute how many ] [sl:recipes_unit_nutrition grams grams ] [sl:recipes_included_ingredient ground beef ] [sl:recipes_included_ingredient hamburger patty ] ]
hang up on xiomara blakey	[in:snooze_alarm [sl:location xiomara blakey ] ]
set weekend alarm to 8 am	[in:create_alarm [sl:date_time weekend weekend ] [sl:date_time to am ] ]
is today 's weather good for swimming ?	[in:get_weather [sl:date_time today today ] [sl:location swimming swimming ] ]
stop call now	[in:silence_alarm ]
show me my weekly alarms	[in:get_alarm [sl:news_source weekly weekly ] ]
what reminders do i have set up for aug 11th ?	[in:get_reminder [sl:person_reminded i i ] [sl:period for 11th ] ]
things to do in miami this weekend	[in:get_event [sl:location miami miami ] [sl:method_timer this weekend ] ]
i feel like listening to some hardcore enka .	[in:stop_music [sl:music_artist_name hardcore enka ] ]
call remi vega in whatsapp video chat	[in:create_call [sl:contact remi vega ] [sl:life_event whatsapp whatsapp ] ]
any softball matches	[in:get_event_attendee [sl:category_event softball matches ] ]
li 's home address	[in:get_location [sl:contact li li ] ] [in:set_rsvp_yes
share the forecast for this weekend .	[in:get_weather [sl:period for weekend ] ]
who is scaramucci	[in:get_stories_news [sl:news_topic scaramucci scaramucci ] ]
what is the ingredients for vegetable soup	[in:get_info_recipes [sl:alarm_name vegetable soup ] ]
remind brady and jackson that we need to leave at 3 ; alert them an hour before .	[in:create_reminder [sl:person_reminded brady brady ] [sl:person_reminded we jackson ] [sl:todo we leave ] [sl:date_time at before ] ]
replay the song from the beginning	[sl:music_type song song ] ]
i need a timer .	[in:create_timer [sl:date_time timer timer ] ]
read me all my reminders from wednesday .	[in:get_reminder [sl:method_retrieval_reminder read read ] [sl:amount all all ] [sl:person_reminded my my ] [sl:method_timer from wednesday ] ]
where 's the second event at ?	[in:get_date_time_event [sl:ordinal second second ] ]
i'd like to call with my cousins ashlyn , linda , chloe , and angel on whatsapp	[in:create_call [sl:contact [in:get_contact [sl:contact_related my my ] [sl:type_relation cousins cousins ] [sl:contact ashlyn ashlyn ] [sl:contact linda linda ] [sl:contact angel angel ] [sl:contact angel chloe angel ] ] ] [sl:name_app whatsapp whatsapp ] ]
cancel my next reminder .	[in:cancel_message [sl:person_reminded my my ] [sl:ordinal next next ] ]
how long should i bake a pound cake	[in:get_info_recipes [sl:recipes_attribute how long ] [sl:recipes_cooking_method bake bake ] [sl:recipes_included_ingredient pound cake ] ]
reminder me one day before judy 's anniversary dinner .	[in:create_reminder [sl:person_reminded me me ] [sl:period one before ] [sl:todo judy dinner ] ]
what will the weather be like in sydney next tuesday	[in:get_weather [sl:location sydney sydney ] [sl:period next tuesday ] ]
remove reminder to email my son 's school .	[in:delete_reminder [sl:todo [in:send_message [sl:method_message email email ] [sl:recipient [in:get_contact [sl:contact_related my my ] [sl:type_relation son school ] ] ] ] ]
how warm is it around san francisco in degree c	[in:get_weather [sl:weather_attribute warm warm ] [sl:location san francisco ] [in:snooze_alarm c c ] ]
get time left on the workout timer	[in:get_timer [sl:timer_name workout workout ] [in:create_alarm [sl:timer_name workout workout ] [sl:method_timer timer timer ] ]
call jeremy	[in:create_call [sl:contact jeremy jeremy ] ] [in:set_default_provider_music
can i listen to she got the best of me	[in:play_music [sl:music_artist_name she me ] ]
send a reminder to dreanna about our nail appointment on sunday .	[in:create_reminder [sl:person_reminded dreanna dreanna ] [sl:todo our appointment ] [sl:period on sunday ] ]
set a reminder to pick up seed at 10 am thursday .	[in:create_reminder [sl:todo pick seed ] [sl:period at thursday ] ]
i want to listen to selena gomez	[in:create_playlist_music [sl:music_artist_name selena gomez ] ]
message dennis and thank him very much for wishing me a happy birthday .	[in:send_message [sl:recipient dennis dennis ] [sl:method_message thank much ] [sl:content_exact thank birthday ] ]
do i have to let it cool off first	[in:get_weather [sl:weather_attribute cool first ] ]
when is my alarm going off next	[in:get_category_event [sl:ordinal next next ] ]
create an alarm for 2 pm	[in:create_alarm [sl:period for pm ] ]
how many slices are in a large pizza pie	[in:get_info_recipes [sl:contact_added how many ] [sl:recipes_dish pizza pie ] ]
give me news of the day .	[in:get_stories_news [sl:news_type news news ] ]
i want you to message ana and let her know i liked her recent post on gardens .	[in:send_message [sl:recipient ana ana ] [sl:recipient i ana ] [sl:content_exact i gardens ] ]
friends of margaret	[sl:type_relation friends friends ] [in:get_contact [sl:type_relation margaret margaret ] ]
make alarm for wednesdays at 6	[in:create_alarm [sl:period for 6 ] ]
please call jane	[in:get_call [sl:contact jane jane ] ]
remind me to start dinner at 5 : 00 pm today	[in:create_reminder [sl:person_reminded me me ] [sl:todo start dinner ] [sl:period at today ] ]
bring glenda into our call	[in:set_rsvp_interested [sl:contact glenda glenda ] ]
please add sharon to call now	[in:update_call [sl:recipes_attribute sharon sharon ] ]
when did joyce graduate from utc ?	[in:get_education_time [sl:contact joyce joyce ] [sl:life_event graduate graduate ] [sl:date_time from utc ] ]
for which company does john work ?	[in:get_undergrad [sl:contact john john ] ]
message fiona that the usher training is at the von braun center on august 15 .	[in:send_message [sl:recipient fiona fiona ] [sl:recipes_type the center ] [sl:date_time on 15 ] ]
give me the news from the new york times	[in:get_stories_news [sl:news_source new times ] ]
show me the weather for next monday and tuesday	[in:get_weather [sl:method_timer [sl:date_time for tuesday ] ]
turn on the ' 80 ' s station	[in:play_music [sl:music_genre 80 80 ] [sl:method_timer station station ] ]
will it rain in westlake today ?	[in:get_weather [sl:weather_attribute rain rain ] [sl:location westlake westlake ] [sl:method_timer today today ] ]
play me a pop song	[in:play_music [sl:contact_related pop pop ] [sl:music_type song song ] ]
who is from boston ?	[in:get_contact [sl:contact boston boston ] ]
call horace tyler	[in:create_call [sl:contact horace tyler ] ] [in:set_default_provider_music
message jb to find out what time the kevin hart show starts .	[in:send_message [sl:recipient jb jb ] [in:get_attendee_event [sl:content_exact what starts ] ]
don't pick this one up	[in:remove_from_playlist_music [sl:amount one one ] ]
play queen .	[in:play_music [sl:music_genre queen queen ] ]
call lorelei weyers facetime	[in:create_call [in:create_call [sl:contact lorelei weyers ] ] ]
call daniella hartman right away	[in:create_call [in:create_call [sl:contact daniella hartman ] ]
what sports match can i go to in february	[in:get_event [sl:category_event sports match ] [sl:period in february ] ]
how do you cook pasta	[in:get_recipes [sl:recipes_included_ingredient pasta pasta ] ]
list the concerts in san franscisco for next week	[in:get_event [sl:category_event concerts concerts ] [sl:location san franscisco ] [sl:method_timer for week ] ]
did john finish high school ?	[in:get_undergrad [sl:contact john john ] [sl:life_event finish school ] ]
what is the latest news on the white supremacist protest	[in:get_stories_news [sl:method_timer latest latest ] [sl:news_type news news ] [sl:news_topic white protest ] ]
what temperature is steak cooked at	[in:get_info_recipes [sl:recipes_attribute temperature temperature ] [sl:recipes_dish steak steak ] ]
message mason to meet in the lobby	[in:send_message [sl:recipient mason mason ] [sl:recipes_type meet lobby ] ]
any news about obama	[sl:type_relation news news ] [sl:news_topic obama obama ] ]
does keanu reeves live in l.a .	[in:get_location [sl:contact keanu reeves ] [sl:location l.a l.a ] ]
please read roanoke news headlines .	[in:get_stories_news [sl:news_source roanoke roanoke ] [sl:news_type news headlines ] ]
set a timer for 8 pm on mondays for bachelorette showings	[in:create_timer [sl:method_timer timer timer ] [sl:date_time for mondays ] [sl:alarm_name bachelorette showings ] ]
text josh wu and debbie that talk to you later	[in:send_message [sl:recipient josh wu ] [sl:recipient debbie debbie ] [in:get_attendee_event ]
call detective	[in:create_call [sl:contact detective detective ] ] [in:set_default_provider_music
add another 5 minutes	[sl:recipes_type_nutrition [sl:date_time 5 minutes ] ]
play r and b music	[in:play_music [sl:music_genre r and ] [sl:music_type music music ] ]
when was the last time i had a video call with john ?	[in:subtract_time_timer ]
what 's the temperature high for the day ?	[in:get_weather [sl:period for day ] ]
play led zeppelin .	[in:play_music [sl:music_artist_name led zeppelin ] ] [in:set_default_provider_music
show me my reminders for my get - together with monique .	[in:get_reminder [sl:method_retrieval_reminder show show ] [sl:person_reminded my my ] [sl:todo [in:get_todo [sl:todo my together ] [in:get_todo [sl:todo my monique ] [sl:attendee monique monique ] ] ] ] ]
how much time until i have to arise ?	[in:get_alarm ]
call miss ruben segouia ' s spouse	[in:create_call [sl:contact [in:get_contact [sl:contact_related ruben segouia ] [sl:type_relation spouse spouse ] ] ] ]
please call bradley and gianna	[in:end_call [sl:contact bradley bradley ] [sl:contact gianna gianna ] ]
let me know all the weekend reminders i set up for the next month	[in:get_reminder [sl:amount all all ] [sl:person_reminded i i ] [sl:method_timer weekend weekend ] ]
create an alarm for the 5.55 and 6 am this thursday	[in:create_alarm [sl:period for thursday ] ]
quit this call .	[in:silence_alarm ]
pause my timer .	[in:pause_timer [sl:date_time timer timer ] ]
what is the weather looking like for the 15th june ?	[in:get_weather [sl:period for june ] ]
things to do in cincinnati next weekend	[in:get_event [sl:location cincinnati cincinnati ] [sl:period next weekend ] ]
list luisa d . kauk cousins upcoming birthdays	[in:get_contact [sl:contact_related luisa kauk ] [in:get_birthday [sl:contact luisa cousins ] ]
daytona events in december	[in:get_event [sl:alarm_name daytona daytona ] [sl:date_time in december ] ]
set up an alarm for 6 : 50 am	[in:create_alarm [sl:period for am ] ]
set alarm to go off every 10 minutes for 1 hour	[in:create_alarm [sl:date_time every hour ] ]
how warm is it for dehli tonight degree fahrenheit	[in:get_weather [sl:weather_attribute warm warm ] [sl:location dehli dehli ] [sl:period tonight tonight ] [sl:weather_temperature_unit fahrenheit fahrenheit ] ]
end current call , start new call	[in:switch_call ]
how long do i cook frozen lasagna	[in:get_info_recipes [sl:recipes_attribute how long ] [sl:recipes_meal frozen frozen ] [sl:recipes_dish lasagna lasagna ] ]
what is the average temperature in hawaii	[sl:recipes_included_ingredient hawaii hawaii ]
set countdown for 1 minute , remind me 10 seconds before end of countdown	[in:create_timer [sl:date_time for minute ] [sl:method_timer countdown countdown ] [sl:amount me me ] [sl:method_timer countdown countdown ] ]
read me all the news stories on kanye west recently	[in:get_stories_news [sl:news_type news stories ] [sl:news_source kanye west ] [sl:date_time recently recently ] ]
current news on the mets	[in:get_stories_news [sl:period current current ] [sl:news_type news news ] [sl:news_topic mets mets ] ]
what is the low temp today	[in:get_weather [sl:method_timer [sl:date_time today today ] ]
i need an alarm for friday	[in:create_alarm [sl:period for friday ] ]
cancel my reminder about the conference	[in:delete_alarm [sl:todo the conference ] ]
i am trying to find out who jerry is	[in:get_message_contact [sl:recipient jerry jerry ] ]
play duran duran on iheartradio	[in:play_music [sl:music_artist_name duran duran ] [sl:music_provider_name iheartradio iheartradio ] ] [in:set_default_provider_music
what concerts are there in febuary	[sl:recipes_unit_measurement concerts concerts ] [sl:date_time in febuary ] ]
create an alarm today at midnight	[in:create_alarm [sl:period today midnight ] ]
whatsapp video call lucy hoffman	[in:create_call [sl:music_provider_name whatsapp whatsapp ] [sl:contact lucy hoffman ] ]
does sam perez live in fort worth ?	[in:get_location [sl:contact sam perez ] [sl:employer fort worth ] ]
how much time is left on the oven timer	[in:get_timer [sl:date_time timer timer ] ]
show me events i rsvpd maybe to	[in:get_event [sl:attendee_event i i ] ]
jerry sounds interesting , who is he ?	[in:get_employer [sl:contact jerry jerry ] [sl:type_contact he he ] ]
add my auntie to this call .	[in:update_call [sl:recipes_attribute [in:update_call [sl:contact_added [in:get_contact [sl:contact_related my my ] [sl:type_relation auntie auntie ] ] ] ]
did any of my friends go to a & m ?	[in:get_contact [sl:contact_related my my ] [sl:type_relation friends friends ] [in:get_sunset m m ] ]
create an alarm at 3 pm for the next 4 weekends	[in:create_alarm [sl:period at pm ] [sl:date_time for weekends ] ]
pause timer until i get back on the track	[in:pause_timer [sl:date_time until timer ] ]
what is the latest in u.s . news	[in:get_stories_news [sl:date_time latest latest ] [sl:location u.s . ] [sl:news_type news news ] ]
remind me to leave for special needs luncheon in fairbanks ranch at 11 : 30pt on september 6	[in:create_reminder [sl:person_reminded me me ] [sl:todo [in:get_todo [sl:todo leave luncheon ] [sl:location fairbanks ranch ] ] ] [sl:date_time at 6 ] ]
give the uncle of iker khan a call	[in:create_call [in:get_contact [sl:type_relation uncle uncle ] [sl:contact_related iker khan ] ] ]
send message to kirk that there are 2 flights to oakland on tuesday	[in:send_message [sl:recipient kirk kirk ] [sl:method_message there flights ] [sl:location oakland oakland ] [sl:date_time on tuesday ] ]
tell me how to make gooey brownies	[in:get_recipes [sl:music_artist_name gooey brownies ] ]
what soccer matches are coming up tonight	[in:get_event [sl:category_event soccer matches ] [sl:period tonight tonight ] ]
how many calories in a slice of key lime pie	[in:get_info_recipes [sl:recipes_attribute how many ] [sl:recipes_unit_nutrition calories calories ] [sl:recipes_included_ingredient lime pie ] ]
remind me saturday to get the kids hair cut .	[in:create_reminder [sl:person_reminded me me ] [sl:date_time saturday saturday ] [sl:todo [in:get_todo [sl:todo get cut ] ] ] ]
set alarm to remember to take my pills	[in:create_alarm [sl:todo take pills ] ]
play john legend 's latest album	[in:play_music [sl:music_artist_name john legend ] [sl:method_recipes latest latest ] [sl:music_type album album ] ]
i want to group call all the friend .	[in:create_call [sl:contact [in:get_stories_news [sl:type_relation friend friend ] ] ] ]
message to family the cancer charity event swim across america denver is at chatfield reservoir .	[in:send_message [sl:todo [in:get_contact [sl:type_relation family family ] ] ] [sl:content_exact the reservoir ] ]
set an alarm for every 10 minutes after 6 am	[in:create_alarm [sl:period every minutes ] [sl:date_time 6 am ] ]
set a timer for 55 minutes	[in:create_timer [sl:todo timer timer ] [sl:date_time for minutes ] ]
can you tell me 7 - day - forecast ?	[in:get_weather [sl:period 7 day ] ]
answer the call from bryce	[in:answer_call [sl:contact bryce bryce ] ] ]
add new timer for 30 seconds .	[in:create_playlist_music [sl:method_timer timer timer ] [sl:date_time for seconds ] ]
what is the latest white house news	[in:get_stories_news [sl:period latest latest ] [sl:news_topic white house ] [sl:news_type news news ] ]
what is the name of this song ?	[in:get_details_news [sl:music_type song song ] ]
remind me to go to doctor tomorrow	[in:create_reminder [sl:person_reminded me me ] [sl:todo go doctor ] [sl:period tomorrow tomorrow ] ]
is alex available to call right now ?	[in:get_message_contact [sl:contact alex alex ] ]
send a message asking ian if he locked the door .	[in:send_message [sl:recipient ian ian ] ]
my daughter has to eat again in 4 hours , please set a timer	[in:create_timer [sl:weather_attribute timer ] [sl:date_time in hours ] [sl:method_timer timer timer ] ]
is nepal still flooded	[in:question_news [sl:news_topic nepal flooded ] ]
play the rock playlist	[in:play_music [sl:contact_related rock rock ] [sl:music_type playlist playlist ] ]
is gina older than me	[in:get_gender [sl:contact gina gina ] ]
call sister in law on speaker phone	[in:create_call [sl:contact [in:get_contact [sl:type_relation sister law ] ] ] [sl:name_app speaker phone ] ]
did the reminder get set for gymnastics tuition	[in:get_reminder_date_time [sl:todo gymnastics tuition ] ]
can you record video for prince	[in:get_stories_news [sl:news_type video video ] [sl:location prince prince ] ]
do i have any weekend reminders with stephanie ?	[in:get_reminder [sl:person_reminded i i ] [sl:date_time weekend weekend ] [sl:todo [in:get_todo [sl:attendee stephanie stephanie ] [sl:date_time ] ] ]
remind me to get pots and pans today	[in:create_reminder [sl:person_reminded me me ] [sl:todo get pans ] [sl:period today today ] ]
has wallenby sent me anything via facebook	[in:get_message [sl:recipient wallenby wallenby ] [sl:recipient me me ] [sl:name_app facebook facebook ] ]
describe the current weather in essex	[in:get_weather [sl:alarm_name essex essex ] ]
send it to merilyn lesniak	[in:send_message [sl:music_artist_name merilyn lesniak ] ]
how much rain are we getting tonight	[in:get_weather [sl:weather_attribute rain rain ] [sl:period tonight tonight ] ]
what type of cheese is on pizza	[in:get_info_recipes [sl:recipes_included_ingredient cheese cheese ] [sl:recipes_included_ingredient pizza pizza ] ]
is there anything important for the today 's news	[in:get_stories_news [sl:method_timer news news ] [sl:date_time for today ] [sl:news_type news news ] ]
how many hours are left til alarm goes off ?	[in:get_alarm [sl:date_time til hours ] ]
please play classic rock music .	[in:play_music [sl:music_genre classic rock ] [sl:recipes_included_ingredient music music ] ]
what is the 10 - day - forecast ?	[in:get_weather [sl:period 10 day ] ]
find me some japanese recipe	[in:get_recipes [in:get_employment_time japanese japanese ] ]
set reminder to pick up medications for 5 pm tonight . set reminder 5 minutes before .	[in:create_reminder [sl:todo [in:get_todo [sl:todo pick medications ] [sl:period for tonight ] ] ] [sl:date_time 5 before ] ]
whats happening in vegas tonight	[in:get_event [sl:location vegas vegas ] [sl:period tonight tonight ] ]
how 's the weather in south yorkshire , england ?	[in:get_weather [sl:news_topic south england ] ]
show those available	[in:replay_music ]
show me ben harper 's mom	[in:get_event [sl:contact_related ben harper ] [sl:type_relation mom mom ] ]
set the timer for 5 minutes	[in:create_timer [sl:date_time for minutes ] ]
start the timer over	[in:resume_timer [sl:date_time [in:replay_music [sl:method_timer timer timer ] ]
could you message a video	[in:send_message [sl:recipes_meal video video ] ]
middle eastern news update headlines	[in:get_stories_news [sl:news_topic middle eastern ] [sl:news_type headlines headlines ] ]
i am currently unavailable	[sl:news_type [in:set_unavailable ]
play wkow on iheartradio	[in:play_music [sl:music_radio_id wkow wkow ] [sl:music_provider_name iheartradio iheartradio ] ]
wake me up in two hours	[in:create_alarm [sl:period in hours ] ]
things to do in miami	[sl:recipes_unit_measurement [sl:location miami miami ] ]
give alexa delgado 's friend a call	[in:create_call [sl:contact [in:get_contact [sl:category_event alexa delgado ] [sl:type_relation friend friend ] ] ] ]
how much has it rained in england this past week ?	[in:get_info_recipes [sl:recipes_attribute how much ] [sl:recipes_included_ingredient rained rained ] [sl:location england england ] [sl:date_time this week ] ]
how long before the alarm goes off ?	[in:get_info_recipes ]
please play metallica 's newest song on spotify .	[in:play_music [sl:music_artist_name metallica metallica ] [sl:music_type song song ] [sl:employer spotify spotify ] ]
9 o'clock alarm please	[in:create_alarm [sl:period 9 o'clock ] ]
what 's the name of this band ?	[in:get_timer [sl:music_type band band ] ]
could you call evelyn glenn 's dad peyton	[in:create_call [sl:contact [in:get_contact [sl:category_event evelyn glenn ] [sl:type_relation dad dad ] [sl:contact peyton peyton ] ] ] ]
set an alarm for 3 am monday , wednesday , and friday .	[in:create_alarm [sl:period for friday ] ]
tuna salad recipe	[in:get_recipes [sl:recipes_included_ingredient tuna salad ] ]
is maggie 47 years old this year	[in:get_age [sl:contact maggie maggie ] [sl:age 47 47 ] [sl:date_time this year ] ]
fun things to do in cleveland later this month	[in:get_event [sl:location cleveland cleveland ] [sl:method_timer later month ] ]
ignore this incoming call	[in:ignore_call ] ]
i want to start a group call with family	[in:create_call [sl:contact [sl:type_relation family family ] ] ]
things to do in december in tucson	[in:get_event [sl:period in december ] [sl:location tucson tucson ] ]
when did sofia graduate ?	[in:get_education_time [sl:contact sofia sofia ] [sl:type_contact graduate graduate ] ]
is it going to be another hot day today ?	[in:get_weather [in:create_alarm [sl:weather_attribute hot hot ] [sl:date_time today today ] ]
delete the reminder about thanksgiving at gary 's house	[in:delete_reminder [sl:date_time about [sl:todo [in:get_todo [sl:todo gary gary ] ] ] ]
find me the local weather news	[in:get_stories_news [sl:news_category local local ] [sl:news_type news news ] ]
how long should i roast a 10 pound turkey for	[in:get_info_recipes [sl:recipes_attribute how long ] [sl:news_reference roast roast ] [sl:recipes_included_ingredient turkey turkey ] ]
find news about angelina jolie divorce	[sl:music_type news news ] [sl:news_topic angelina divorce ] ]
set up a reminder to purchase ingredients for tomorrow 's dinner	[in:create_reminder [sl:todo purchase dinner ] ] [sl:recipes_unit_nutrition
what 's happening in portland tonight	[in:get_event [sl:location portland portland ] [sl:method_timer tonight tonight ] ]
call aubrie number four	[in:create_call [sl:contact aubrie aubrie ] [sl:recipes_attribute four four ] ]
any special events in daytona beach this coming weekend	[in:get_event [sl:location daytona beach ] [sl:method_timer this weekend ] ]
can i make bread without yeast	[in:get_recipes [sl:recipes_dish bread bread ] [sl:recipes_excluded_ingredient yeast yeast ] ]
play nickelback	[in:play_music [sl:music_artist_name nickelback nickelback ] ] [in:set_default_provider_music
what 's the name of that performer of this song .	[in:get_track_info_music [sl:music_type performer performer ] ]
have the president made any further remarks on what went on in charlottesville this past weekend	[in:question_news [sl:news_topic president charlottesville ] [sl:date_time this weekend ] ]
set alarm for 4 : 45 pm	[in:create_alarm [sl:period for pm ] ]
cancel all of my reminders for tomorrow .	[in:delete_reminder [sl:amount all all ] [sl:person_reminded my my ] [sl:method_timer for tomorrow ] ]
play formation on iheartradio	[in:play_music [sl:recipes_diet formation formation ] [sl:music_provider_name iheartradio iheartradio ] ]
change my 9 pm reminder to 9 : 30	[in:update_reminder_date_time [sl:person_reminded my my ] [sl:period 9 pm ] [sl:date_time to 30 ] ]
what is the number song on itunes right now ?	[in:question_music [sl:music_type song song ] [sl:music_provider_name itunes itunes ] ]
update today 's alert 15 minutes later	[in:update_reminder_date_time [sl:method_timer today today ] [sl:date_time 15 later ] ]
start a video call with anne	[in:create_call [sl:contact anne anne ] ] [in:silence_alarm
is there anticipated rain tonight ?	[in:get_weather [sl:weather_attribute rain rain ] [sl:period tonight tonight ] ]
how long until the time goes off ?	[in:get_alarm ]
i want to call christopher clark archer	[in:create_call [in:create_call [sl:contact christopher archer ] ] ]
get rid of all my set alarms .	[in:delete_reminder [sl:amount all all ] ]
add my father to the call	[in:update_call [sl:recipes_attribute [in:create_call [sl:contact [in:get_contact [sl:contact_related my my ] [sl:type_relation father father ] ] ] ] ]
tell me who is online now ?	[in:get_availability ] ]
pause the alarm please	[in:pause_music ]
did any of my family go to princeton ?	[in:get_contact [sl:contact_related my my ] [sl:type_relation family family ] [sl:weather_temperature_unit princeton princeton ] ]
how do i tell if an egg has gone bad	[in:get_info_recipes ]
how humid is it this week ?	[in:get_weather [sl:weather_attribute humid humid ] [sl:period this week ] ]
call philip for me	[in:create_call [sl:contact_added philip philip ] ]
i need lisa 's email	[in:get_message [sl:recipient lisa lisa ] [in:get_message_contact ]
change the date for the picnic reminder from this saturday to next saturday .	[in:update_reminder_date_time [sl:todo the picnic ] [sl:period from saturday ] [sl:date_time to saturday ] ]
play me some country	[in:play_music [sl:contact_related country country ] ]
should i wear rain boots	[sl:weather_attribute rain boots ]
love that song , repeat it	[in:repeat_all_off_music ]
please add mum now	[sl:contact_added [in:get_contact [sl:type_relation mum mum ] ] ]
how do you make quiche ?	[in:get_recipes [sl:recipes_included_ingredient quiche quiche ] ]
most recent news	[in:get_stories_news [sl:period most recent ] [sl:news_type news news ] ]
read me additional details	[in:get_stories_news [in:help_reminder ]
find me a recipe for chicken tetrazzini , please	[in:get_recipes [sl:recipes_included_ingredient chicken tetrazzini ] [sl:recipes_dish chicken tetrazzini ] ]
set the timer for 8 minutes .	[in:create_timer [sl:date_time for minutes ] ]
set recurring larms everyday for 7 am and 7 : 10 am please .	[in:create_alarm [sl:period everyday larms ] [sl:date_time for am ] ]
set as not around	[in:silence_alarm ]
does mandy work for bb & t ?	[in:get_employer [sl:contact mandy mandy ] [sl:group bb t ] ]
should i wear a rain coat today	[in:get_weather [sl:weather_attribute rain coat ] [sl:method_timer today today ] ]
who is on concert this week in atlanta	[in:get_contact [sl:category_event concert concert ] [sl:date_time this week ] [sl:location atlanta atlanta ] ]
try calling ng angelica	[in:create_call [sl:contact ng angelica ] ] [in:stop_music
restart the timer	[in:restart_timer [sl:date_time ]
open iheart radio and play midnight on shuffle	[in:start_shuffle_music [sl:music_type radio radio ] [sl:music_album_title midnight midnight ] ]
make an alarm for weekdays	[in:create_alarm [sl:period for weekdays ] ]
text on my way to lance and kenny	[in:send_message [sl:attendee lance lance ] [sl:recipient kenny kenny ] ]
what is tom 's number	[in:get_location [sl:contact tom tom ] ]
message hadley saying just for surety , can you get a zin	[in:send_message [sl:recipient hadley hadley ] [sl:content_exact surety zin ] ]
delete all my existing alarms .	[sl:recipes_unit_nutrition [sl:amount all all ] ]
play some zz top please .	[in:play_music [sl:music_artist_name zz zz ] [sl:music_playlist_title top top ] ]
what is alan 's address ?	[in:get_location [sl:contact alan alan ] ] [in:get_employer
delete a minute	[in:delete_alarm [sl:date_time a minute ] ]
skip this track and go to the next song .	[in:skip_track_music [sl:music_type track track ] ]
give ahmed a call	[in:get_education_degree [sl:contact ahmed ahmed ] ]
what 's the weather forecast for 3 pm on monday the 1st in dubai ?	[in:get_weather [sl:date_time for 1st ] [sl:alarm_name dubai dubai ] ]
sunny on thursday ?	[in:get_weather [sl:weather_attribute sunny sunny ] [sl:period on thursday ] ]
i need a great vegan side dish	[in:get_info_recipes [sl:recipes_type vegan vegan ] [sl:recipes_included_ingredient side dish ] ]
play me some david lee roth	[in:play_music [sl:contact_related david roth ] ]
remind me to text martha tomorrow .	[in:create_reminder [sl:person_reminded me me ] [sl:todo [in:send_message [sl:method_message text text ] [sl:recipient martha martha ] ] ] [sl:period tomorrow tomorrow ] ]
what is the latest news about racism	[in:get_stories_news [sl:period latest latest ] [sl:news_type news news ] [sl:news_topic racism racism ] ]
i need an alarm set for 5 am	[in:create_alarm [sl:period for am ] ]
call grandmothers	[in:create_call [sl:contact [in:get_contact [sl:type_relation grandmothers grandmothers ] ] ] ] ]
video message michaela	[in:send_message [sl:recipes_meal video video ] [sl:recipient michaela michaela ] ]
remind me of my 10 : 00 am doctor 's appointment	[in:create_reminder [sl:person_reminded me me ] [sl:todo [in:get_todo [sl:date_time 10 am ] [sl:todo doctor appointment ] ] ]
i'm really busy right now	[sl:news_type ]
what is the latest in the black lives matter movement	[in:get_info_recipes [sl:ordinal latest latest ] [sl:news_topic black matter ] ]
show me messages from bill murray via messenger	[in:get_message [sl:contact bill murray ] [sl:name_app messenger messenger ] ]
initiate a call with first time home buyers	[in:create_call [sl:ordinal first first ] [sl:contact [in:get_location ] ] ]
connect call to susan	[in:end_call [sl:contact susan susan ] ]
clear out alarms indefinitely	[sl:recipes_unit_nutrition [in:delete_alarm ]
remind me to call aliana and ask about headstart program , later at 5 : 15 pm .	[in:create_reminder [sl:person_reminded me me ] [sl:todo [in:get_todo [sl:todo [in:create_call [sl:contact aliana aliana ] ] ] [sl:todo ask program ] ] ] [sl:method_timer later pm ] ]
can you set a timer named software update	[in:create_timer [sl:date_time timer timer ] [sl:timer_name software software ] ]
change my status to interested for los angeles interactive conference 2019	[in:set_rsvp_no [sl:title_event los 2019 ] ]
tell me billy 's address	[in:get_call [sl:contact billy billy ] ]
set alarm for 10 pm tonight	[in:create_alarm [sl:period for tonight ] ]
have vincent roberts taken off the group call	[in:reply_message [in:update_call [sl:contact_removed vincent roberts ] ]
dinner will be ready at 6 : 30 , remind me at 6 : 00 to start the rice .	[in:create_reminder [sl:todo [in:get_todo [sl:todo dinner ready ] [sl:date_time at 30 ] ] [sl:todo start rice ] ] ]
please get rid of that reminder to have the oil changed in the saturn .	[in:delete_alarm [sl:todo have saturn ] ]
i want to set a get ready for bed alarm at 10 pm	[in:create_alarm [sl:alarm_name get bed ] [sl:period at pm ] ]
play save tonight by will.i.am	[in:play_music [sl:music_track_title tonight tonight ] [sl:music_artist_name will.i.am will.i.am ] ]
what is the weather for long beach tomorrow morning 0800 hours ?	[in:get_weather [sl:location long beach ] [sl:period tomorrow hours ] ]
set alarm at 10 pm tonight .	[in:create_alarm [sl:period at tonight ] ]
remind me with an alarm in 10 minutes	[in:create_reminder [sl:person_reminded me me ] [sl:date_time in minutes ] ]
play the last track from talking to the taxman	[in:play_music [sl:music_type track track ] [sl:music_track_title taxman taxman ] ]
what 's the address of my work ?	[in:get_location [sl:contact_related my my ] ]
what ingredients are in the orange chicken	[in:get_info_recipes [sl:recipes_attribute ingredients ingredients ] [sl:recipes_included_ingredient orange chicken ] ]
i want to appear as available	[in:set_unavailable ]
what should the temperature be for well done meat	[in:get_info_recipes [sl:recipes_attribute temperature temperature ] [sl:amount well done ] [sl:recipes_included_ingredient meat meat ] ]
call my sibling on whatsapp	[in:create_call [sl:contact [in:get_contact [sl:contact_related my my ] [sl:type_relation sibling sibling ] ] ] [sl:name_app whatsapp whatsapp ] ] [in:get_employer
set my alarm for 3 pm .	[in:create_alarm [sl:period for pm ] ]
who is singing	[sl:music_album_title ]
remind me to book my flight to germany today .	[in:create_reminder [sl:person_reminded me me ] [sl:todo [in:get_todo [sl:todo book flight ] [sl:location germany germany ] ] ] [sl:method_timer today today ] ]
news about hillary clinton	[in:get_stories_news [sl:news_type news news ] ]
please make repeating alarms at 7 pm and 9 pm on tuesdays .	[in:create_alarm [sl:method_timer [sl:date_time at tuesdays ] ]
check if susan is online	[in:get_availability [sl:contact susan susan [in:reply_message ]
please play a luke bryan playlist .	[in:play_music [sl:music_artist_name luke bryan ] [sl:music_type playlist playlist ] ]
please send that video to the code blue thread	[in:send_message [sl:type_content video video ] [sl:group blue blue ] ]
latest sports headlines	[in:get_stories_news [sl:period latest latest ] [sl:news_category sports sports ] [sl:news_type headlines headlines ] ]
call playwright	[in:create_call [sl:contact playwright playwright ] ] [in:set_default_provider_music
start a call spoken word	[in:update_method_call ]
are two of my friends online	[in:get_availability ] ]
does george clonney have any children ?	[in:get_gender [sl:contact george clonney ] ]
i need to submit my application to the school this afternoon ; can you remind me at 1 pm ?	[in:create_reminder [sl:person_reminded i i ] [sl:todo submit school ] [sl:date_time at afternoon ] ]
what 's the latest ncaa football news ?	[in:get_stories_news [sl:date_time latest latest ] [sl:news_category ncaa football ] [sl:news_type news news ] ]
please tell me the weather for australia	[in:get_weather [sl:location australia australia ] ] ]
message a video to scarlett	[in:send_message [sl:type_content video video ] [sl:contact scarlett scarlett ] ]
resume my laundry timer	[in:resume_timer [sl:timer_name laundry laundry ] [sl:date_time timer timer ] ]
are there any new taylor swift headlines ?	[in:get_stories_news [sl:alarm_name taylor swift ] [sl:news_type headlines headlines ] ]
total time left on timer .	[in:update_timer [sl:method_timer timer timer ] ]
leave call and go to new call	[sl:life_event [in:switch_call ]
i need the weather prediction for townsville , on saturday , at 6 : 00 pm .	[in:get_weather [sl:location townsville townsville ] [sl:period on pm ] ]
what year did carol get promoted to manager ?	[in:get_date_time_event [sl:contact carol carol ] [sl:news_topic manager manager ] ]
remind me to call the dentist	[sl:recipes_attribute [in:create_reminder [sl:person_reminded me me ] [sl:todo [in:create_call [sl:contact the dentist ] ] ] ]
i like this song .	[in:replay_music [sl:music_type song song ] ]
start calling mom	[in:create_call [in:create_call [sl:contact [in:get_contact [sl:type_relation mom mom ] ] ] ] ]
start this track over	[in:restart_timer [sl:music_type track track ] ]
not going to po ' boy pop - up	[in:set_rsvp_no [sl:alarm_name po up ] ]
call sofia ' s cousin	[in:create_call [sl:contact [in:get_contact [in:get_event [sl:contact_related sofia sofia ] [sl:type_relation cousin cousin ] ] ] ] ]
has gabriel sent me any messages ?	[in:update_reminder [sl:contact gabriel gabriel ] [sl:recipient me me ] ]
mark song as favorite	[sl:contact_removed [sl:music_type song song ] ]
apply alarm friday afternoon at 4 pm	[in:create_alarm [sl:period friday pm ] ]
play me some indy rap underground death metal music .	[in:play_music [sl:music_playlist_title indy metal ] [sl:music_type music music ] ]
set another timer for 40 minutes	[in:create_timer [sl:todo timer timer ] [sl:date_time for minutes ] ]
where dany currently live now ?	[in:get_life_event [sl:contact dany dany ] ]
warn mom i may be early because i'm making great time .	[in:send_message [sl:recipient [in:get_contact [sl:type_relation mom mom ] ] ] [sl:recipes_unit_nutrition early early ] ]
what is local news this morning	[in:get_stories_news [sl:news_category local local ] [sl:news_type news news ] [sl:period this morning ] ]
message a video to charles price cook	[in:send_message [sl:type_content video video ] [sl:group charles price ] ]
initiate a call with brandon , bailey , and blake on line	[in:create_call [sl:contact brandon brandon ] [sl:contact bailey bailey ] [sl:contact blake blake ] [sl:ordinal line line ] ]
message kam and tell her hair appt july 1st	[in:send_message [sl:recipient kam kam ] [sl:content_exact tell 1st ] ]
remind me to send out the email in 15 minutes .	[in:create_reminder [sl:person_reminded me me ] [sl:todo [in:send_message [sl:method_message email email ] [sl:content_exact send email ] ] ] [sl:date_time in minutes ] ]
let jax no that we will still have the cookout at my mother 's house friday	[in:send_message [sl:recipes_attribute jax jax ] [sl:content_exact we friday ] ]
hang up the video call	[in:update_call ]
nix the reminder for my 2 pm racket ball game .	[in:update_reminder_date_time [sl:person_reminded my my ] [sl:todo 2 ball ] [sl:todo racket game ] ]
remind me that the walking dead comes on sunday at 7 pm	[in:create_reminder [sl:person_reminded me me ] [sl:todo the comes ] [sl:period on pm ] ]
anything going down	[in:get_event ] ]
skip this music please	[in:stop_music [sl:music_type music music ] ]
what kind of chocolate is there in a chocolate cake ?	[in:get_info_recipes [sl:recipes_included_ingredient chocolate chocolate ] [sl:recipes_included_ingredient chocolate cake ] ]
set alarm for 9 : 00 am tomorrow morning	[in:create_alarm [sl:period for tomorrow ] ]
how do i cook a medium rare steak	[in:get_info_recipes [sl:ordinal medium rare ] [sl:recipes_included_ingredient steak steak ] ]
what is the weather in county limerick right now	[in:get_sunset [sl:location county limerick ] ]
any comedy shows to go to on saturday	[in:get_event [sl:category_event comedy shows ] [sl:method_timer on saturday ] ]
i want to know if anyone works at walmart .	[in:get_contact [sl:group walmart walmart ] ]
who was gayle kings ex husband ?	[in:get_contact [in:get_event [sl:contact_related gayle kings ] [sl:type_relation ex husband ] ]
set alarm for 7 am monday through friday .	[in:create_alarm [sl:period for friday ] ]
start playing frank & back to black	[in:play_music [sl:music_track_title frank black ] ]
make a grocery alarm at 6 pm today	[in:create_alarm [sl:alarm_name grocery grocery ] [sl:period at today ] ]
get rid of the reminder about finishing up the hummus in the fridge	[in:delete_alarm [sl:todo finishing fridge ] ]
need alarm 4 pm	[in:create_alarm [sl:period 4 pm ] ]
where does michael live ?	[in:get_location [sl:contact michael michael ] ] [in:get_employer
set alarm for 6 : 30	[in:create_alarm [sl:period for 30 ] ]
is there any recent breaking news about iran ?	[in:get_stories_news [sl:period recent recent ] [sl:news_reference breaking breaking ] [sl:news_type news news ] [sl:news_topic iran iran ] ]
take 23 seconds off the timer	[in:subtract_time_timer [sl:date_time 23 seconds ] [sl:date_time timer timer ] ]
i need a chicken parmesan recipe	[sl:recipes_attribute [in:get_recipes [sl:recipes_dish chicken parmesan ] ]
ask rob how bad the traffic is	[in:send_message [sl:recipient rob rob ] [sl:recipes_type how is ] ]
what basketball matches are happening	[sl:recipes_unit_measurement basketball matches ]
did maria finished her master degrees ?	[in:get_education_time [sl:contact maria maria ] [sl:life_event master master ] ]
how much time left on timer	[in:get_timer [sl:method_timer time time ] [sl:music_type timer timer ] ]
are there any nearby tornado warnings ?	[sl:todo nearby tornado ] ]
remind me about dentist appointment tomorrow afternoon	[in:create_reminder [sl:person_reminded me me ] [sl:todo dentist appointment ] [sl:period tomorrow afternoon ] ]
make a video for lewis	[in:get_recipes [sl:type_content video video ] [sl:recipes_dish lewis lewis ] ]
show reminders for this week	[in:get_reminder [sl:method_retrieval_reminder show show ] [sl:method_timer for week ] ]
clear any remaining reminders	[in:delete_reminder ] ]
make an alarm for 5 am	[in:create_alarm [sl:period for am ] ]
rsvp no to planet home	[in:delete_alarm [sl:alarm_name planet home ] ]
add my stepparents to this call	[in:update_call [sl:recipes_attribute [in:update_call [sl:contact_added [in:get_contact [sl:contact_related my my ] [sl:type_relation stepparents stepparents ] ] ] ]
send that video message via facebook	[in:get_message_contact [sl:type_content video video ] [sl:name_app facebook facebook ] ]
events in berkeley this weekend	[in:get_event [sl:location berkeley berkeley ] [sl:method_timer this weekend ] ]
is it true that paul lives in garden grove ?	[in:get_location [sl:contact paul paul ] [sl:employer garden grove ] ]
delete all my reminders for this friday .	[in:delete_reminder [sl:amount all all ] [sl:person_reminded my my ] [sl:method_timer for friday ] ]
when is dawn tomorrow	[in:get_sunrise [sl:period tomorrow tomorrow ] ]
what is the high today	[in:get_weather [sl:period today today ] ]
cancel my reminder to get tacos for dinner dads cooking steaks instead .	[sl:amount [sl:person_reminded my my ] [sl:todo get steaks ] ]
how many people died in salt lake city today	[in:question_news [sl:news_topic people city ] [sl:date_time today today ] ]
ping phillip	[in:create_call [sl:contact phillip phillip ] ] [in:get_employer
do i know anybody from hawaii	[in:get_contact [sl:contact_related i i ] [sl:employer hawaii hawaii ] ]
have an alert for my doctors appointment on monday at 8 am and 830 am	[in:create_alarm [sl:alarm_name doctors appointment ] [sl:date_time on am ] ]
what is the calorie count in fried chicken	[in:get_info_recipes [sl:recipes_unit_nutrition calorie calorie ] [sl:recipes_included_ingredient fried chicken ] ]
did john video call me yesterday ?	[in:get_call [sl:contact john john ] [sl:method_timer yesterday yesterday ] ]
do i have a shopping reminder	[in:get_reminder [sl:person_reminded i i ] [sl:recipes_attribute shopping shopping ] ]
how long do the coals heat up before you put on the meat	[in:get_info_recipes [sl:recipes_attribute how long ] [sl:recipes_cooking_method coals coals ] [sl:recipes_included_ingredient meat meat ] ]
where in seattle does jane live ?	[in:get_location [sl:contact seattle seattle ] [sl:contact jane jane ] ]
set my alarm for 30 minutes .	[in:create_alarm [sl:period for minutes ] ]
play the song i want you back .	[in:replay_music [sl:music_type song song ] [sl:music_track_title i back ] ]
list of events in chicago next week	[in:get_event [sl:location chicago chicago ] [sl:method_timer next week ] ]
give the grandfather of justin a call	[in:create_call [sl:contact [in:get_contact [sl:type_relation grandfather grandfather ] [in:get_age [sl:type_relation justin justin ] ] ] ]
set an alarm for 1 minute	[in:create_alarm [sl:period for minute ] ]
play me some eminem .	[in:play_music [in:play_music [sl:music_artist_name eminem eminem ] ]
how much time is left on second timer ?	[in:get_timer [sl:ordinal second second ] [sl:date_time on second ] [sl:method_timer timer timer ] ]
what were the headlines yesterday	[in:get_stories_news [sl:news_type headlines headlines ] [sl:period yesterday yesterday ] ]
set alarm called lunchtime at noon	[in:create_alarm [sl:recipes_cooking_method lunchtime lunchtime ] [sl:date_time at noon ] ]
i need to know what the weather will be like over the weekend	[in:get_weather [sl:period over weekend ] ]
when is the carpet cleaning reminder	[in:get_reminder_date_time [sl:recipes_attribute carpet cleaning ] [sl:todo carpet cleaning ] ]
who graduated from bue last year ?	[in:get_contact [sl:school bue bue ] [sl:method_timer last year ] ]
how many people are online right now ?	[in:set_available ]
show the event reminders for this weekend .	[in:get_reminder [sl:method_retrieval_reminder show show ] [sl:method_timer [sl:date_time for weekend ] ]
add a message to the group that the meeting is changed to 6 : 30 tonight	[in:send_message [sl:recipient the changed ] [sl:content_exact the tonight ] ]
how do i cook deer	[in:get_weather [sl:weather_attribute deer deer ] ]
reset the timer for 10 more minutes	[in:update_alarm [sl:method_timer timer timer ] [sl:date_time for minutes ] ]
what is the weather like outside now ?	[in:get_weather ] ]
remind me to send a birthday message to alex tomorrow at noon .	[in:create_reminder [sl:person_reminded me me ] [sl:todo [in:send_message [sl:method_message message message ] [sl:recipient alex alex ] ] [sl:method_message message noon ] ] ] [sl:date_time tomorrow noon ] ]
who works at the local toyota dealership ?	[in:get_contact [sl:group local dealership ] ]
try giving a call to brandon saint	[sl:contact brandon saint ] ]
text mini mouse and everett that happy new years	[in:send_message [sl:recipient mini mouse ] [sl:recipient everett everett ] [sl:todo happy years ] ]
set up ' funeral ' alarm for june 2nd at 3 p	[in:create_alarm [sl:alarm_name funeral funeral ] [sl:date_time for p ] [sl:date_time for p ] ]
could you remind me to go to bennie 's house before big johnnie gets there on saturday night .	[in:create_reminder [sl:person_reminded me me ] [sl:todo [in:get_todo [sl:todo go house ] [sl:date_time on night ] ] ] ]
what is the best way to cook fish	[in:get_recipes [sl:recipes_rating best best ] [sl:recipes_included_ingredient fish fish ] ]
what are the details about donald trump firing his staff ?	[in:get_stories_news [sl:news_type details details ] ]
what is steven 's number ?	[in:get_contact_method [sl:contact steven steven ] ]
tell me the latest news on the washington post	[in:get_stories_news [sl:period latest latest ] [sl:news_type news news ] [sl:news_source washington post ] ]
who is available now	[in:get_availability ] ]
call my friend andy nelson on whatsapp	[in:create_call [sl:contact [in:get_contact [sl:contact_related my my ] [sl:type_relation friend friend ] [sl:contact andy nelson ] [sl:name_app whatsapp whatsapp ] ] ]
start a video call with my bro .	[in:create_call [sl:contact [in:get_contact [sl:contact_related my my ] [sl:type_relation bro bro ] ] ] ]
what is the recipe for arroz con pollo	[in:get_recipes [sl:recipes_type arroz pollo ] ]
show me the forecast for northern france .	[in:get_weather [sl:alarm_name northern france ] ]
set timer for 23 minutes .	[in:create_timer [sl:date_time for minutes ] [sl:method_timer timer timer ] ]
what is the weather locally	[in:get_weather ] ]
please dial addisyn paul right away	[in:create_call [in:create_call [sl:contact addisyn paul ] ] ]
how many calories in a bowl of miso soup	[in:get_info_recipes [sl:recipes_attribute how many ] [sl:recipes_unit_nutrition calories calories ] [sl:recipes_dish miso soup ] ]
what 's the weather like in swindon ?	[in:get_weather [sl:news_topic swindon swindon ] ]
are there any volleyball matches happening soon	[in:get_timer [sl:category_event volleyball matches ] ]
i want you to set a timer for one hour	[in:create_timer [sl:date_time for hour ] [sl:method_timer timer timer ] ]
hang up the call .	[in:merge_call ]
start the timer in 2 hours	[in:create_timer [sl:date_time in hours ] [sl:method_timer timer timer ] ]
let 's start recording a video message for joelle dechellis	[in:send_message [sl:recipes_meal video video ] [sl:recipient joelle dechellis ] ]
what are some recent sports headlines ?	[in:get_stories_news [sl:date_time recent recent ] [sl:news_category sports sports ] [in:get_alarm ] [sl:news_type headlines headlines ] ]
drop the call from sally	[in:update_call [sl:contact_removed sally sally ] ]
set timer for 2 min 30 sec	[in:create_timer [sl:method_timer timer timer ] [sl:date_time for 30 ] ]
news about south china sea dispute	[sl:type_content news news ] [sl:news_topic south dispute ] ]
do you know the name of the album this song is from ?	[in:get_details_news [sl:music_type album album ] [sl:music_type song song ] ]
skip current song	[in:skip_track_music [sl:contact current current ] [sl:music_type song song ] ]
find august alsina	[in:create_call [sl:contact august alsina ] ]
cancel the egg timer	[in:delete_timer [sl:timer_name egg egg ] [sl:amount [sl:todo egg timer ] ]
adjust timer to 20 minutes	[in:add_time_timer [sl:method_timer timer timer ] [sl:date_time to minutes ] ]
tell robert to start the message tree . the car wash has been cancelled because of rain .	[in:send_message [sl:recipient robert robert ] [sl:method_message start rain ] ]
friends of my sister	[sl:type_relation friends friends ] [sl:contact_related my sister ] ]
message to mom that aunt mary 's dinner is on saturday at 5	[in:send_message [sl:recipient [in:get_contact [sl:type_relation mom mom ] ] ] [sl:recipient [in:get_contact [sl:type_relation aunt aunt ] ] ] [sl:content_exact mary 5 ] ]
how many minutes until the timer beeps ?	[in:get_timer [sl:date_time until minutes ] [sl:method_timer timer timer ] ]
i would like to only use amazon	[in:set_default_provider_music [sl:title_event amazon amazon ] ]
engage alarm	[in:get_alarm ]
i'd like to know the name of this album .	[in:get_details_news [sl:music_type album album ] ]
play wsvo radio	[in:play_music [sl:music_playlist_title wsvo wsvo ] [sl:music_type radio radio ] ]
set an alarm for 3 minutes	[in:create_alarm [sl:period for minutes ] ]
call uncle at home	[in:create_call [sl:contact [in:get_contact [sl:type_relation uncle uncle ] [sl:gender home home ] ] ] ]
is it foggy this morning	[in:get_weather [sl:weather_attribute foggy foggy ] [sl:period this morning ] ]
set a work alarm tomorrow for 5 am tomorrow .	[in:create_alarm [sl:alarm_name work work ] [sl:period tomorrow tomorrow ] ]
please read me details on anderson cooper 's last reports .	[in:get_stories_news [sl:news_type details details ] ]
set this call as video only	[in:update_method_call ] [in:stop_music
call dylan ' s aunt	[in:create_call [sl:contact [in:get_contact [sl:category_event aunt aunt ] [sl:type_relation aunt aunt ] ] ] ]
remind me to call tim after work tomorrow at 6 pm	[in:create_reminder [sl:person_reminded me me ] [sl:todo [in:get_todo [sl:todo [in:create_call [sl:contact tim tim ] ] ] [sl:date_time tomorrow pm ] ] ]
end the call because i do not want to talk anymore	[in:delete_alarm ]
tell me the weather conditions for this afternoon	[in:get_weather [sl:period for afternoon ] ]
can you please send message to the code blue group	[in:send_message [sl:recipient the blue ] ]
i want replies from greg today	[in:get_message [sl:sender greg greg ] [sl:method_timer today today ] ]
what time did i call dad ?	[in:subtract_time_timer [sl:todo [in:create_call [sl:contact [in:get_contact [sl:type_relation dad dad ] ] ] ] ]
will it snow later this afternoon ?	[in:get_weather [sl:weather_attribute snow snow ] [sl:period later afternoon ] ]
tell me more about who raquel is	[in:replay_music [sl:contact raquel raquel ] ]
i want to see whitehorse mommies upcoming birthdays	[in:get_contact [in:get_event [sl:contact_related whitehorse whitehorse ] [sl:type_relation mommies mommies ] ]
could you tell me the weather in paris ?	[sl:weather_attribute paris paris ]
video calling on	[in:create_call ]
move the event reminder to sunday .	[in:update_reminder_date_time [sl:period to sunday ] ]
play the song summer	[in:play_music [sl:music_type song song ] [sl:music_provider_name summer summer ] ]
delete reminder for my brother 's family dinner next saturday evening .	[in:delete_reminder [sl:todo my dinner ] [sl:period next evening ] ]
text steve that i wont be at the next meeting	[in:send_message [sl:recipient steve steve ] ]
call isabelle ' s boyfriend	[in:create_call [sl:contact [in:get_contact [sl:category_event boyfriend boyfriend ] [sl:type_relation boyfriend boyfriend ] ] ] ]
set up reminder to get oil change wednesday .	[in:create_reminder [sl:todo get change ] [sl:period wednesday wednesday ] ]
what 's yesterday 's headlines ?	[in:get_stories_news [sl:date_time yesterday yesterday ] [in:get_alarm ] [sl:news_type headlines headlines ] ]
tell me who works for a printing company	[in:get_contact [sl:job printing company ] ]
last playlist again	[in:replay_music [sl:music_type playlist playlist ] ]
get rid of any reminders for the bus tour this coming weekend	[in:delete_reminder [sl:todo the tour ] [sl:period this weekend ] ]
i want to hear kaskade 's most recent album	[in:play_music [sl:music_track_title kaskade kaskade ] [sl:music_type album album ] ]
what friend is from seattle ?	[in:get_contact [sl:type_relation friend friend ] [sl:weather_attribute seattle seattle ] ]
what does leslie like to do ?	[in:get_info_contact [sl:contact leslie leslie ] ]
share po ' boy pop - up with john	[in:share_event [sl:title_event po pop ] [sl:contact john john ] ]
tell reggie we canceled the party tomorrow	[in:send_message [sl:recipient reggie reggie ] [sl:title_event we tomorrow ] ]
message a video to dylan	[in:send_message [in:get_stories_news [sl:type_content video video ] [sl:recipient dylan dylan ] ]
show me reminders for 5 pm on thursday	[in:get_reminder [sl:method_retrieval_reminder show show ] [sl:person_reminded me me ] [sl:period for thursday ] ]
play some old janet jackson songs	[in:play_music [sl:music_genre old jackson ] [sl:music_type songs songs ] ]
what is the temperature for barcelona , spain ?	[in:get_weather [sl:alarm_name barcelona spain ] ]
what time is the dawn on saturday	[in:get_sunrise [sl:method_timer on saturday ] ]
how many calories in a piece of chocolate cake	[in:get_info_recipes [sl:recipes_attribute how many ] [sl:recipes_unit_nutrition calories calories ] [sl:recipes_included_ingredient chocolate cake ] ]
set alarms for 6 am and 6.30am every tuesday	[in:create_alarm [sl:period for tuesday ] [sl:date_time every tuesday ] ]
call pedro using whatsapp video chat	[in:create_call [sl:contact pedro pedro ] [sl:music_provider_name whatsapp whatsapp ] ]
read details about disney streaming service article	[in:get_stories_news [sl:news_type details details ] [sl:news_source disney service ] ]
call londyn steele call rowan salinas in whatsapp	[in:create_call [sl:contact londyn steele ] [sl:contact rowan salinas ] [sl:name_app whatsapp whatsapp ] ]
can you read current news headlines regarding world news	[in:get_stories_news [sl:date_time current current ] [sl:news_type news headlines ] [sl:news_category world world ] [in:cancel_call ]
list my reminders for next monday	[in:get_reminder [sl:method_retrieval_reminder list list ] [sl:person_reminded my my ] [sl:period for monday ] ]
is there a thunderstorm watch ?	[in:get_weather [sl:music_genre thunderstorm thunderstorm ] ]
email needed for alexandra zane	[in:send_message [sl:content_exact alexandra zane ] ]
set 10 minute timer to start in 1 hour	[in:create_timer [sl:date_time 10 minute ] [sl:date_time in hour ] [sl:method_timer timer timer ] ]
set a new alarm for wednesday at 8 am	[in:create_alarm [sl:period for am ] ]
start my timer .	[in:create_timer [sl:date_time timer timer ] ]
remind me about my lunch date at 12 : 00 pm with co - workers on friday .	[in:create_reminder [sl:person_reminded me me ] [sl:todo [in:get_todo [sl:todo my date ] [sl:date_time at pm ] [sl:todo with friday ] ] ]
play the new haim song .	[in:play_music [sl:music_artist_name haim haim ] [sl:music_type song song ] ]
set a timer for 8 hours	[in:create_timer [sl:date_time for hours ] [sl:method_timer timer timer ] ]
change the playlist	[in:replay_music [sl:music_type playlist playlist ] ]
what ingredients are in chicken pot pie	[in:get_info_recipes [sl:recipes_attribute ingredients ingredients ] [sl:recipes_included_ingredient chicken pie ] ]
things to do today	[in:get_event [sl:period today today ] ]
message benji to see if he left his towel at my house last night	[in:send_message [sl:recipient benji benji ] [sl:location he house ] [sl:content_exact he night ] ]
what ingredients do i need to make lasagna	[in:get_info_recipes [sl:recipes_attribute ingredients ingredients ] [sl:news_topic lasagna lasagna ] ]
are there any weather watches right now ?	[in:get_weather [sl:method_timer watches watches ] ]
what time is sunset tonight	[in:get_sunset [sl:period tonight tonight ] ]
what is the humidity percentage for today ?	[in:get_weather [sl:weather_attribute humidity humidity ] [sl:period for today ] ]
can you please send message to kelly and adam waverly	[in:get_message_contact [sl:recipient kelly kelly ] [sl:recipient adam waverly ] ]
can somebody allergic to coconut have canola oil	[in:is_true_recipes [sl:recipes_cooking_method allergic allergic ] [sl:recipes_included_ingredient coconut oil ] ]
message kirk saying i need coffee please	[in:send_message [sl:recipient kirk kirk ] [sl:recipient i coffee ] ]
what 's the weekend forecast	[in:get_weather [sl:period weekend weekend ] ]
is there anything interesting to do in oconto tonight	[in:get_event [sl:location oconto oconto ] [sl:period tonight tonight ] ]
will it be sunny next weekend ?	[in:get_weather [sl:weather_attribute sunny sunny ] [sl:period next weekend ] ]
who 's not busy	[in:get_call_contact ]
where can i have fun in the morning	[in:get_event [sl:period in morning ] ]
set spotify as the default app for music	[in:stop_music [sl:music_provider_name spotify spotify ] ]
make a wake up alarm at 3 pm on thursday	[in:create_alarm [sl:alarm_name wake up ] [sl:period at thursday ] ]
how much cumin do i add to mexican rice	[in:get_info_recipes [sl:recipes_attribute how much ] [sl:recipes_type_nutrition cumin cumin ] [sl:recipes_dish mexican rice ] ]
what can you tell me about bob ?	[in:replay_music [sl:contact bob bob ] ]
set a timer to pull cookies out of the oven in 12 minutes	[in:create_timer [sl:method_timer timer timer ] [sl:period pull in ] ]
play 90s ballads	[in:play_music [sl:music_genre 90s 90s ] [sl:music_genre ballads ballads ] ]
play the 1962 the hangover part ii	[in:play_music [sl:music_track_title 1962 ii ] ]
add twenty minutes to cole 's time out timer	[in:add_time_timer [sl:date_time twenty minutes ] [sl:timer_name cole cole ] [sl:method_timer timer timer ] ]
find a recipe for zucchini lasagna .	[in:send_message [sl:recipes_dish zucchini lasagna ] ]
remind me in 20 minutes to turn on skype	[in:create_reminder [sl:person_reminded me me ] [sl:date_time in minutes ] [sl:recipes_attribute turn skype ] ]
what is the latest headlines ?	[in:get_stories_news [sl:period latest latest ] [sl:news_type headlines headlines ] ]
call easton valdez 's kid valeria walter	[in:create_call [sl:contact [in:get_contact [sl:category_event easton valdez ] [sl:type_relation kid kid ] [sl:contact valeria walter ] ] ] ]
can you give me details about the last election	[in:get_details_news [sl:news_type details details ] ]
update status to available	[in:get_call_time ]
remind me to set prenantal classes and email john the schedule of classes .	[in:create_reminder [sl:person_reminded me me ] [sl:todo set classes ] ]
display art shows happening sunday	[in:get_event [sl:category_event art shows ] [sl:period sunday sunday ] ]
read all news on magnolia , texas	[sl:music_type news news ] [sl:news_topic magnolia texas ] ]
create a call with sean hogan , chelsey mcgee , nathanael jennings , and kade solis	[in:create_call [sl:contact sean hogan ] [sl:contact chelsey mcgee ] [sl:contact kade jennings ] [sl:contact kade solis ] ]
when is it going to snow	[sl:weather_attribute snow snow ] ]
set alarm for 11 : 30 pm	[in:create_alarm [sl:period for pm ] ]
change the mode to unavailable	[in:set_unavailable ] [in:silence_alarm
remind me to call larry on monday at 8 pm central time .	[in:create_reminder [sl:person_reminded me me ] [sl:todo [in:get_todo [sl:todo [in:create_call [sl:contact larry larry ] ] ] ] [sl:date_time on time ] ]
change my 3 minute timer to 6 minutes	[in:restart_timer [sl:date_time 3 minute ] [sl:method_timer timer timer ] [sl:date_time to minutes ] ]
hang up this call	[in:merge_call ]
what concerts are coming up	[in:get_event [sl:title_event concerts concerts ] ]
set a reminder to call dad at 7 pm .	[in:create_reminder [sl:todo [in:create_call [sl:contact [in:get_contact [sl:type_relation dad dad ] ] ] ] ] [sl:period at pm ] ]
remind me to call dave .	[sl:recipes_attribute [in:create_reminder [sl:person_reminded me me ] [sl:todo [in:create_call [sl:contact dave dave ] ] ] ]
how many minutes do i have left on my timer ?	[in:get_timer [sl:date_time timer timer ] ]
message mom and tell her my plane what will be at least 2 hours late flying into austin , tx .	[in:send_message [sl:recipient [in:get_contact [sl:type_relation mom mom ] ] ] [sl:recipient [in:get_contact [sl:type_relation my my ] ] [sl:content_exact my tx ] ]
use apple music as my default	[in:stop_music [sl:music_provider_name apple music ] ]
delete all old timers	[in:delete_timer [sl:amount all all ] [sl:date_time all all ] [sl:method_timer timers timers ] ]
who does jessica work for ?	[in:get_info_contact [sl:contact jessica jessica ] ]
play anderson . paak 's album for me .	[in:play_music [in:play_music [sl:music_artist_name anderson paak ] [sl:music_type album album ] ]
where does vanessa live ?	[in:get_location [sl:contact vanessa vanessa ] ] [in:get_employer
remind me to return my online purchase to nordstrom	[sl:recipes_attribute [sl:person_reminded me me ] [sl:todo return nordstrom ] ]
is anything showing tonight	[in:get_event [sl:period tonight tonight ] ]
next week 's forecast ?	[in:get_weather [sl:period next week ] ]
move the reminder for face cream from 8 to 9	[in:update_reminder_date_time [sl:todo face cream ] [sl:date_time from 8 ] [sl:period to 9 ] ]
show me no bake brownie recipes	[in:get_recipes [sl:recipes_cooking_method bake bake ] [sl:recipes_dish brownie brownie ] ]
finish call now	[in:create_call ]
snooze my alarm for another 5 minutes please	[in:snooze_alarm [sl:period for minutes ] ]
headlines on cnn please	[in:get_stories_news [sl:news_type headlines headlines ] [sl:life_event cnn cnn ] ]
create a remind to call mom at 7 pm	[in:create_reminder [sl:todo [in:create_call [sl:contact [in:get_contact [sl:type_relation mom mom ] ] ] ] ] [sl:period at pm ] ]
please check is sarah is available	[in:replay_music [sl:contact sarah sarah ] ]
add reminder to call dentist for appointment	[sl:amount [sl:todo [in:get_todo [sl:todo [in:create_call [sl:contact dentist dentist ] ] ] [sl:todo appointment appointment ] ] ] ]
gluten free muffin recipe	[in:get_recipes [sl:recipes_cuisine gluten free ] [sl:recipes_dish muffin muffin ] ]
can you please send text to tad and james	[in:get_recipes [sl:recipient tad tad ] [sl:recipient james james ] ]
set alarm for 5 am tomorrow	[in:create_alarm [sl:period for tomorrow ] ]
what temperature should you re - heat pizza	[in:get_info_recipes [sl:recipes_attribute temperature temperature ] [sl:alarm_name heat pizza ] ]
set timer to know when to stop the oven	[in:update_alarm [sl:method_timer timer timer ] ]
where is troy from ?	[in:get_undergrad [sl:contact troy troy ] ]
play hip hop songs .	[sl:music_artist_name hip hop ]
what time is the day and time for the reminder for the doctor appointment for tina ?	[in:get_reminder_date_time [sl:todo the appointment ] [sl:location tina tina ] ]
movies playing next week in corpus christi	[in:get_event [sl:category_event movies playing ] [sl:date_time next week ] [sl:news_topic corpus christi ] ]
where does maged work ?	[in:get_undergrad [sl:contact maged maged ] ]
remind me on saturday .	[in:create_reminder [sl:person_reminded me me ] [sl:method_timer on saturday ] ]
give my mum a buzz	[in:play_music [sl:music_genre mum mum ] [sl:music_provider_name buzz buzz ] ]
where does brad live ?	[in:get_location [sl:contact brad brad ] ] [in:get_employer
when was the last time i had a reminder set to water the plants ?	[in:get_reminder_date_time [sl:amount last last ] [sl:person_reminded i i ] [sl:todo water plants ] ]
hang up an accept new call and do not allow other calls to come in now	[in:end_call ]
let chris know we are meeting his family at the auburn hills cafe rio at 9 p.m .	[in:send_message [sl:recipient chris chris ] [sl:attendee auburn rio ] [sl:content_exact we p.m ] ]
did jack message me last night ?	[in:get_message [sl:sender jack jack ] [sl:recipient me me ] [sl:period last night ] ]
weather for christmas in new york please	[in:get_weather [sl:period for christmas ] [sl:location new york ] ]
what 's happening in atlanta	[in:get_event [sl:alarm_name atlanta atlanta ] ]
how many inches of rain have fallen ?	[in:get_weather [in:create_alarm [sl:weather_attribute rain rain ] ]
what is the water temperature at grand haven beach today	[in:get_weather [sl:alarm_name water water ] [sl:location grand beach ] [sl:date_time today today ] ]
would you record video message to jon	[in:send_message [sl:recipes_meal video video ] [sl:recipient jon jon ] ]
how many calories in a tablespoon of peanut butter	[in:get_info_recipes [sl:recipes_attribute how many ] [sl:recipes_unit_nutrition calories calories ] [sl:recipes_unit_measurement tablespoon tablespoon ] [sl:recipes_dish peanut butter ] ]
what is happening this weekend locally	[in:get_event [sl:period this weekend ] ]
set a reminder to animal and house sit for sister during thanksgiving week with two reminders 10 days before and 5 days before	[in:create_reminder [sl:todo [in:get_todo [sl:todo animal sister ] ] [sl:date_time during week ] ] ]
how many eggs are used in a quiche	[in:get_info_recipes [sl:recipes_attribute how many ] [sl:recipes_included_ingredient eggs eggs ] [sl:recipes_cuisine quiche quiche ] ]
please remove all reminders for the cycle group for the rest of this year .	[in:delete_reminder [sl:amount all all ] [sl:person_reminded cycle cycle ] [sl:period for year ] ]
weather forecast for mexico .	[in:get_weather [sl:news_topic mexico mexico ] ]
rsvp no to giants at patriots	[in:set_rsvp_no [sl:news_source patriots patriots ] ]
available people please	[in:replay_music ]
set an alarm now	[in:silence_alarm ]
are there any reminders for chemistry homework next week ?	[in:get_reminder [sl:todo chemistry homework ] [sl:period next week ] ]
tell me how old kade is .	[in:get_location [sl:contact kade kade ] ]
please accept the video call from my cousins	[in:update_method_call [sl:contact [in:get_contact [sl:contact_related my my ] [sl:type_relation cousins cousins ] ] ] ]
let me know when timer is halfway done	[in:update_timer [sl:method_timer timer timer ] ]
what time did alison video call me	[in:set_available [sl:contact alison alison ] ]
a playlist for popular madonna songs	[in:create_playlist_music [sl:music_type playlist playlist ] [sl:music_artist_name madonna madonna ] ]
remind my teammates that the next game is blue uniforms	[in:create_reminder [sl:person_reminded my my ] [sl:todo the uniforms ] [sl:todo the uniforms ] ]
what temperature should i roast a chicken at	[in:get_info_recipes [sl:recipes_attribute temperature temperature ] [sl:recipes_cooking_method roast roast ] [in:create_alarm [sl:recipes_attribute chicken chicken ] ]
is beth still living in columbus ?	[in:question_news [sl:location beth beth ] [sl:location columbus columbus ] ]
put on some hip hop music	[sl:music_artist_name hip hop ]
set a reminder to call john	[in:create_reminder [sl:todo [in:create_call [sl:contact john john ] ] ] ] ]
set weekly alarm for saturdays 8 am	[in:create_alarm [sl:date_time weekly weekly ] [sl:date_time for am ] ]
make a reminder for school tomorrow	[in:create_reminder [sl:todo school school ] [sl:period tomorrow tomorrow ] ]
please modify the reminder of my math test today to next friday	[in:update_reminder_date_time [sl:person_reminded my my ] [sl:todo my test ] [sl:date_time today today ] [sl:date_time to friday ] ]
are there any big elections in the news the week ?	[in:get_stories_news [sl:news_reference big big ] [sl:news_type news news ] [sl:date_time the week ] ]
what is a good crock pot recipe for chicken	[in:get_recipes [sl:recipes_rating good good ] [sl:recipes_cooking_method crock pot ] [sl:recipes_dish chicken chicken ] ]
play news on nbc	[sl:music_type news news ] [sl:news_source nbc nbc ] ]
let kait know i'll be late because of the traffic on rt 18	[sl:contact_added kait kait ] [sl:name_app 18 18 ] ]
who sings the theme song to frazier ?	[in:get_track_info_music [sl:music_type song song ] [sl:employer frazier frazier ] ]
play song again	[in:restart_timer [sl:music_type song song ] ]
sundown is at what time ?	[in:get_alarm ]
what temperature do i cook the turkey to	[in:get_info_recipes [sl:amount temperature temperature ] [sl:recipes_included_ingredient turkey turkey ] ]
squash casserole recipe	[in:get_recipes [sl:recipes_type squash casserole ] ]
set a timer for a half an hour and then 45 minutes	[in:create_timer [sl:method_timer timer timer ] [sl:date_time for hour ] [sl:period 45 minutes ] ]
is there a concert this weekend	[in:get_event [sl:category_event concert concert ] [sl:period this weekend ] ]
down town appleton events in april	[in:get_event [sl:alarm_name down appleton ] [sl:date_time in april ] ]
who does yuri work for ?	[in:get_job [sl:contact yuri yuri ] ]
shut down the alarm	[in:silence_alarm ] ]
set up a reminder for my daughter to visit her cousin abby before she leaves for college in 4 days !	[in:create_reminder [sl:person_reminded [in:get_contact [sl:contact_related my my ] [sl:type_relation daughter daughter ] ] ] [sl:todo visit abby ] [sl:date_time in days ] ]
remind jack that its my birthday next week	[in:send_message [sl:person_reminded jack jack ] [sl:todo its birthday ] [sl:date_time next week ] ]
call my father .	[in:create_call [sl:contact [sl:contact [in:get_contact [sl:contact_related my my ] [sl:type_relation father father ] ] ] ]
set up a reminder for tomorrow to pack band aids and epi pens for the trip .	[in:create_reminder [sl:period for tomorrow ] [sl:todo pack trip ] ]
what is today 's forecast ?	[in:get_weather [sl:period today today ] ]
is there a tornado watch for this area in the next week	[in:get_weather [sl:weather_attribute tornado tornado ] [sl:location this week ] ]
message ben to let him know that we are not going to the concert like we originally planned	[in:send_message [sl:recipient ben ben ] [sl:recipes_type we planned ] ]
create a workout timer that ends in 30 minutes	[in:create_timer [sl:date_time in minutes ] [sl:method_timer timer timer ] [sl:date_time in minutes ] ]
message tommy and let him know the theater is now showing the movie he wants to see .	[in:send_message [sl:recipient tommy tommy ] [sl:location [in:get_event_attendee [sl:content_exact the see ] ] ]
message jordan that i am on my way to football match	[in:send_message [sl:recipient jordan jordan ] [sl:recipes_type i match ] ]
please call ruby callie mclean	[in:create_call [in:create_call [sl:contact ruby mclean ] ] ]
how do you julienne carrots	[in:get_info_recipes [sl:recipes_included_ingredient julienne carrots ] ]
display my texts on facebook	[in:get_message [sl:music_provider_name facebook facebook ] ]
who of my friends has lived in chicago ?	[in:get_contact [sl:category_event friends friends ] [sl:location chicago chicago ] ]
what album is the highest gross in the us this year	[in:question_music [sl:music_type album album ] [sl:recipes_dish us us ] [sl:date_time this year ] ]
play my favorite playlist .	[in:play_music [sl:music_playlist_title favorite favorite ] [sl:music_type playlist playlist ] ]
has there been any recent news about guam	[in:get_stories_news [sl:period recent recent ] [sl:news_type news news ] [sl:news_topic guam guam ] ]
switch the current call to a video call .	[in:answer_call ]
make myself available	[sl:music_playlist_title ]
what is ahmed 's current job ?	[in:get_life_event [sl:contact ahmed ahmed ] ]
got a call , turn it down	[in:create_alarm ]
who died in the charlottesville riot	[in:get_details_news [sl:news_topic charlottesville riot ] ]
place a video call with knitting	[in:create_call [sl:contact knitting knitting ] ]
can you call briana using messenger	[in:create_call [sl:contact briana briana ] [sl:contact_method messenger messenger ] ]
show me danvers 10 day forecast	[in:get_weather [sl:location danvers danvers ] ]
can i wear sandals ?	[in:get_weather [sl:weather_temperature_unit sandals sandals ] ]
sound alarm at 2325	[in:create_alarm [sl:period at 2325 ] ]
add 20 minutes to pasta timer	[in:add_time_timer [sl:date_time 20 minutes ] [sl:timer_name pasta pasta ] [sl:date_time timer timer ] ]
call up ryan and kameron alvarez	[in:get_call [sl:contact ryan ryan ] [sl:contact kameron alvarez ] ]
what are the ingredients in a mcchicken	[in:get_info_recipes [sl:recipes_attribute ingredients ingredients ] [sl:recipes_diet mcchicken mcchicken ] ]
how warm is it today	[in:get_weather [sl:weather_attribute warm warm ] [sl:period today today ] ]
call my cousin on whatsapp for me	[in:create_call [sl:contact [in:get_contact [sl:contact_related my my ] [sl:type_relation cousin cousin ] ] [sl:name_app whatsapp whatsapp ] ]
how windy is it on the beach	[in:get_weather [sl:alarm_name windy windy ] [sl:location beach beach ] ]
please record a video message for dana thompson and carla nguyen	[in:send_message [sl:recipes_meal video video ] [sl:recipient dana thompson ] [sl:recipient carla nguyen ] ]
remind me on thursday to start diet	[in:create_reminder [sl:person_reminded me me ] [sl:period on thursday ] [sl:todo start diet ] ]
set alarm for 3 am on the 23rd	[in:create_alarm [sl:period for 23rd ] ]
how did people prepare for the hurricane	[in:question_news [sl:news_topic hurricane hurricane ] ]
i want to do something tonight	[in:get_event [sl:period tonight tonight ] ]
does sam live and work in denver ?	[in:get_location [sl:contact sam sam ] [sl:location denver denver ] ]
i want to watch the bachelorette at 7 pm could you remind me ten minutes before	[in:create_reminder [sl:todo [in:get_todo [sl:todo watch bachelorette ] [sl:date_time at pm ] ] ] [sl:person_reminded me me ] [sl:period ten before ] ]
respond interested to digital urbanisms conference	[sl:recipes_rating digital digital ]
what is my next alarm	[in:get_category_event [sl:ordinal next next ] ]
set an alarm for 30 minutes from now	[in:create_alarm [sl:period for now ] ]
how much sugar is in a slice of pizza	[in:get_info_recipes [sl:recipes_attribute how much ] [sl:recipes_type_nutrition sugar sugar ] [sl:recipes_dish pizza pizza ] ]
call grandsons	[in:create_call [in:create_call [sl:contact [in:get_contact [sl:type_relation grandsons grandsons ] ] ] ] ]
did the fbi director get fired today ?	[in:question_news [sl:news_topic fbi fired ] [sl:method_timer today today ] ]
can you reduce the timer in half now	[in:update_timer [sl:date_time in now ] [sl:method_timer timer timer ] ]
does anybody live in chicago ?	[in:get_contact [sl:weather_attribute chicago [sl:location chicago chicago ] ]
show me the latest news .	[in:get_stories_news [sl:period latest latest ] [sl:news_type news news ] ]
is tara 's employer in new jersey ?	[in:get_employer [sl:contact tara tara ] [sl:employer new jersey ] ]
need to get stuff for lasagna friday . . . . remind me thursday night	[in:create_reminder [sl:todo get lasagna ] [sl:person_reminded me me ] [sl:date_time thursday night ] ]
did andy ever work for comcast ?	[in:get_employer [sl:contact andy andy ] [sl:music_type comcast comcast ] ]
is it hot outside ?	[sl:weather_attribute hot hot ]
did anyone of my friends graduate from ucla	[sl:type_relation friends friends ] [sl:school ucla ucla ] ]
message reggie and tell her to come to my house	[in:send_message [sl:recipient reggie reggie ] [sl:location [in:get_contact [sl:employer come house ] ] ]
what are the ingredients in quiche	[in:get_info_recipes [sl:recipes_attribute ingredients ingredients ] [sl:music_track_title quiche quiche ] ]
send a message to ms davis that joey will be late	[in:send_message [sl:recipient ms davis ] [sl:type_content joey late ] ]
message jill she can bring her boyfriend to help if he 's free	[in:send_message [sl:recipient jill jill ] [sl:recipes_type she free ] ]
what news is on nbc ?	[sl:music_type news news ] [sl:news_source nbc nbc ] ]
set alarm for 8 am weekends	[in:create_alarm [sl:period for weekends ] ]
set a reminder for me to ask my boss about a pay raise tomorrow .	[in:create_reminder [sl:person_reminded me me ] [sl:todo ask raise ] [sl:period tomorrow tomorrow ] ]
find me how many albums does shakira has ?	[in:play_music [sl:music_type albums albums ] [sl:music_artist_name shakira shakira ] ]
how do i make huevos rancheros	[in:get_recipes [sl:group huevos rancheros ] ]
what should the oven be set to heat up pizza	[in:get_info_recipes [sl:recipes_cooking_method heat oven ] [sl:recipes_attribute heat pizza ] ]
give me a local news update for indianapolis	[in:get_stories_news [sl:recipes_unit_measurement local local ] [sl:news_type news news ] [sl:news_topic indianapolis indianapolis ] ]
tell me the weather forecast for melbourne	[in:get_weather [sl:news_topic melbourne melbourne ] ]
can i go see a concert in la over the weekend	[in:get_event [sl:category_event concert concert ] [sl:location la la ] [sl:period over weekend ] ]
snooze alarm off	[in:snooze_alarm ] [in:silence_alarm
how much longer	[in:get_alarm ]
what internal temperature should a pork chop be in order to be safe	[in:get_info_recipes [sl:recipes_attribute temperature temperature ] [sl:weather_attribute pork chop ] ]
